unit,bulls,cows,calves,total_harvest,total_hunters,percent_success,total_rec_days,year
2,6,0,0,6,8,75,122,2006
201,5,0,0,5,6,83,57,2006
3,5,0,0,5,96,5,860,2006
301,0,0,0,0,46,0,301,2006
4,65,25,0,90,406,22,2832,2006
441,14,6,0,20,121,17,745,2006
5,33,15,0,48,172,28,1242,2006
6,25,15,0,40,323,12,2100,2006
7,32,16,0,48,412,12,2943,2006
8,20,0,0,20,279,7,2314,2006
9,0,0,0,0,59,0,346,2006
10,1,0,0,1,17,6,224,2006
11,0,0,0,0,137,0,756,2006
211,41,15,0,56,241,23,1438,2006
12,74,5,0,79,577,14,4274,2006
13,35,0,0,35,151,23,869,2006
131,40,5,0,45,212,21,1158,2006
231,31,10,0,41,425,10,2827,2006
14,56,25,0,81,557,15,4050,2006
214,81,15,5,101,419,24,2669,2006
15,71,30,5,106,801,13,5902,2006
16,20,0,0,20,278,7,1706,2006
161,31,10,0,41,456,9,3433,2006
17,5,10,0,15,334,4,2563,2006
171,15,0,0,15,212,7,1508,2006
18,30,15,0,45,781,6,5313,2006
181,0,0,0,0,172,0,1015,2006
19,10,0,0,10,425,2,3539,2006
191,6,6,0,12,87,14,890,2006
20,51,4,0,55,199,28,1499,2006
21,40,30,0,70,517,14,3785,2006
22,46,5,0,51,340,15,2201,2006
23,25,35,5,65,413,16,2830,2006
24,119,20,0,139,662,21,4961,2006
25,15,20,0,35,346,10,2317,2006
26,25,5,0,30,288,10,1789,2006
27,35,10,5,50,363,14,2238,2006
28,35,20,0,55,608,9,4673,2006
29,4,2,0,6,35,17,266,2006
30,5,0,0,5,192,3,1224,2006
31,10,10,0,20,183,11,1274,2006
32,41,5,0,46,299,15,1699,2006
33,81,0,0,81,455,18,3698,2006
34,15,0,0,15,207,7,1324,2006
35,15,5,5,25,252,10,1986,2006
36,20,10,5,35,571,6,3830,2006
37,30,10,0,40,442,9,3194,2006
371,5,10,0,15,240,6,1632,2006
38,20,10,0,30,441,7,3213,2006
39,39,8,0,47,122,39,1275,2006
391,2,0,0,2,41,5,382,2006
40,15,0,0,15,98,15,872,2006
41,10,20,0,30,307,10,2107,2006
411,0,10,0,10,161,6,1232,2006
42,66,15,5,86,732,12,5843,2006
421,61,15,10,86,677,13,4970,2006
43,107,10,5,122,718,17,4831,2006
44,25,20,5,50,450,11,3184,2006
444,41,10,0,51,308,17,2258,2006
45,25,10,5,40,468,9,3493,2006
46,5,2,0,7,73,10,616,2006
461,13,0,0,13,55,24,605,2006
47,10,5,0,15,142,11,1107,2006
471,15,15,0,30,76,39,404,2006
48,41,0,0,41,176,23,1683,2006
481,18,0,0,18,110,16,1104,2006
49,22,4,0,26,179,15,1765,2006
50,2,5,0,7,116,6,1012,2006
500,17,2,0,19,116,16,1103,2006
501,10,0,0,10,85,12,764,2006
51,10,0,0,10,82,12,866,2006
511,15,10,0,25,469,5,4235,2006
52,26,5,0,31,259,12,2076,2006
521,71,46,5,122,601,20,4949,2006
53,56,36,0,92,577,16,4139,2006
54,31,15,0,46,646,7,4470,2006
55,61,56,5,122,1137,11,8199,2006
551,20,5,5,30,357,8,2980,2006
56,8,0,0,8,129,6,1372,2006
561,14,0,0,14,85,16,676,2006
57,5,2,0,7,82,9,501,2006
58,10,4,0,14,76,18,606,2006
581,5,5,5,15,144,10,1025,2006
59,10,10,0,20,205,10,1476,2006
591,5,0,0,5,129,4,1068,2006
60,10,0,0,10,96,10,657,2006
61,41,2,0,43,128,34,1302,2006
62,153,81,0,234,1829,13,14257,2006
63,0,10,0,10,276,4,2294,2006
64,15,5,0,20,198,10,1123,2006
65,35,10,5,50,688,7,4652,2006
66,31,7,0,38,248,15,1817,2006
67,10,0,0,10,100,10,729,2006
68,20,10,0,30,318,9,2297,2006
681,20,15,5,40,261,15,2163,2006
682,0,0,0,0,5,0,10,2006
69,11,3,0,14,96,15,926,2006
691,0,0,0,0,55,0,325,2006
70,92,25,10,127,824,15,6371,2006
71,77,81,5,163,1002,16,7936,2006
711,15,10,5,30,369,8,2822,2006
72,5,0,0,5,110,5,922,2006
73,15,10,0,25,216,12,1933,2006
74,71,25,5,101,646,16,4526,2006
741,15,10,0,25,96,26,582,2006
75,36,15,0,51,521,10,4019,2006
751,15,20,0,35,257,14,2035,2006
76,63,4,0,67,232,29,1933,2006
77,61,10,0,71,548,13,4041,2006
771,5,0,0,5,46,11,268,2006
78,51,25,5,81,592,14,4567,2006
79,20,0,5,25,217,12,1583,2006
791,0,0,0,0,10,0,60,2006
80,45,20,10,75,742,10,5948,2006
81,66,25,5,96,771,12,5784,2006
82,20,0,0,20,232,9,1507,2006
83,5,0,0,5,106,5,817,2006
84,5,0,0,5,69,7,615,2006
85,26,10,0,36,428,8,3596,2006
851,12,5,0,17,67,25,483,2006
86,25,15,0,40,372,11,2903,2006
861,15,0,0,15,71,21,443,2006
87,0,0,0,0,5,0,41,2006
88,0,0,0,0,5,0,36,2006
94,0,0,0,0,5,0,10,2006
951,0,0,0,0,10,0,36,2006
101,0,0,0,0,21,0,123,2006
103,0,0,0,0,5,0,26,2006
104,0,0,0,0,15,0,124,2006
106,2,0,0,2,12,17,85,2006
107,0,0,0,0,41,0,235,2006
109,0,0,0,0,5,0,36,2006
110,0,0,0,0,5,0,5,2006
112,0,0,0,0,10,0,46,2006
114,0,0,0,0,10,0,66,2006
116,0,0,0,0,10,0,56,2006
118,0,0,0,0,5,0,15,2006
119,0,0,0,0,5,0,31,2006
120,0,0,0,0,5,0,70,2006
121,0,0,5,5,5,100,62,2006
128,0,0,0,0,31,0,233,2006
129,0,0,0,0,5,0,20,2006
133,0,0,0,0,10,0,76,2006
135,0,0,0,0,5,0,31,2006
140,0,0,0,0,86,0,529,2006
141,5,0,0,5,10,50,36,2006
142,5,0,0,5,10,50,25,2006
147,0,0,0,0,5,0,36,2006
2,3,0,0,3,6,50,108,2007
201,8,0,0,8,8,100,92,2007
3,8,0,0,8,115,7,797,2007
301,8,0,0,8,35,23,204,2007
4,42,27,0,69,376,18,2259,2007
441,27,8,0,35,110,32,600,2007
5,19,23,0,42,156,27,1045,2007
6,8,9,8,25,278,9,1874,2007
7,6,12,0,18,510,4,3990,2007
8,39,0,0,39,294,13,2238,2007
9,4,0,0,4,41,10,251,2007
10,8,0,0,8,14,57,99,2007
11,21,4,0,25,132,19,819,2007
211,93,25,0,118,269,44,1860,2007
12,154,43,4,201,615,33,4018,2007
13,36,20,0,56,197,28,1359,2007
131,25,17,0,42,270,16,1694,2007
231,13,12,0,25,433,6,3263,2007
14,91,25,8,124,684,18,5266,2007
214,61,29,4,94,368,26,2234,2007
15,72,0,4,76,651,12,5059,2007
16,25,0,0,25,367,7,2804,2007
161,29,12,0,41,366,11,2815,2007
17,17,16,0,33,347,10,2477,2007
171,20,13,0,33,268,12,1582,2007
18,43,9,0,52,632,8,4820,2007
181,4,4,0,8,116,7,827,2007
19,0,10,0,10,417,2,2938,2007
191,12,0,0,12,107,11,604,2007
20,43,12,0,55,183,30,1593,2007
21,79,21,12,112,508,22,4182,2007
22,38,13,0,51,348,15,2697,2007
23,105,25,0,130,460,28,3490,2007
24,78,4,0,82,493,17,3127,2007
25,29,4,0,33,284,12,1944,2007
26,36,9,0,45,257,18,1731,2007
27,12,0,0,12,212,6,1558,2007
28,30,26,0,56,517,11,3882,2007
29,5,0,0,5,37,14,363,2007
30,0,0,0,0,202,0,1402,2007
31,12,4,0,16,200,8,1213,2007
32,36,12,4,52,304,17,1824,2007
33,74,8,8,90,618,15,4680,2007
34,26,13,0,39,243,16,1587,2007
35,21,4,4,29,325,9,2180,2007
36,38,12,0,50,568,9,3906,2007
37,31,4,4,39,421,9,2888,2007
371,13,0,0,13,130,10,583,2007
38,13,13,0,26,339,8,2283,2007
39,29,10,0,39,118,33,1101,2007
391,8,0,0,8,30,27,350,2007
40,20,0,0,20,85,24,822,2007
41,12,21,0,33,250,13,1529,2007
411,13,8,0,21,149,14,932,2007
42,73,24,8,105,692,15,4647,2007
421,29,29,8,66,583,11,4302,2007
43,68,12,0,80,639,13,4535,2007
44,25,4,0,29,377,8,2345,2007
444,25,17,4,46,369,12,2570,2007
45,17,4,0,21,446,5,3377,2007
46,6,0,0,6,65,9,497,2007
461,13,4,0,17,78,22,677,2007
47,25,0,0,25,149,17,848,2007
471,9,4,0,13,89,15,512,2007
48,18,8,0,26,139,19,1244,2007
481,5,0,0,5,103,5,856,2007
49,39,10,7,56,188,30,1824,2007
50,4,0,0,4,97,4,822,2007
500,24,0,0,24,120,20,1069,2007
501,12,0,0,12,92,13,791,2007
51,12,0,0,12,74,16,781,2007
511,13,9,4,26,413,6,3261,2007
52,4,13,0,17,271,6,1862,2007
521,52,58,4,114,612,19,4830,2007
53,61,21,8,90,527,17,3658,2007
54,44,30,4,78,787,10,5227,2007
55,78,29,4,111,947,12,6864,2007
551,12,4,0,16,308,5,2077,2007
56,5,0,0,5,120,4,997,2007
561,5,4,0,9,95,9,796,2007
57,14,0,0,14,66,21,678,2007
58,17,4,0,21,86,24,673,2007
581,4,0,0,4,162,2,1094,2007
59,8,4,0,12,191,6,1562,2007
591,4,4,0,8,101,8,848,2007
60,8,0,0,8,53,15,350,2007
61,44,1,0,45,86,52,1128,2007
62,184,91,4,279,1744,16,13177,2007
63,12,8,0,20,224,9,1707,2007
64,24,4,0,28,250,11,1793,2007
65,48,25,8,81,597,14,4334,2007
66,32,3,0,35,193,18,1605,2007
67,16,2,0,18,80,23,645,2007
68,29,8,4,41,328,13,2295,2007
681,17,0,8,25,238,11,1837,2007
682,0,0,0,0,4,0,20,2007
69,4,0,0,4,71,6,735,2007
691,0,0,0,0,4,0,39,2007
70,81,47,12,140,714,20,5425,2007
71,75,37,8,120,955,13,6861,2007
711,32,38,8,78,369,21,2958,2007
72,8,12,0,20,171,12,1297,2007
73,40,4,0,44,221,20,2112,2007
74,38,24,0,62,598,10,4641,2007
741,13,0,0,13,56,23,397,2007
75,22,17,4,43,510,8,3503,2007
751,29,0,0,29,274,11,1873,2007
76,58,0,4,62,218,28,1914,2007
77,24,8,4,36,568,6,3946,2007
771,12,0,0,12,82,15,441,2007
78,65,12,4,81,568,14,4078,2007
79,4,0,0,4,147,3,982,2007
791,0,0,0,0,8,0,31,2007
80,54,12,0,66,792,8,5773,2007
81,64,29,17,110,837,13,6129,2007
82,26,4,0,30,276,11,1580,2007
83,17,13,0,30,140,21,881,2007
84,4,5,0,9,78,12,672,2007
85,60,4,0,64,457,14,3446,2007
851,18,4,0,22,115,19,658,2007
86,17,22,0,39,402,10,3083,2007
861,4,4,0,8,43,19,214,2007
87,0,0,0,0,12,0,84,2007
88,0,4,0,4,4,100,20,2007
99,0,0,0,0,8,0,47,2007
101,0,0,0,0,4,0,43,2007
104,2,0,0,2,13,15,105,2007
105,0,0,0,0,4,0,13,2007
106,0,0,0,0,8,0,62,2007
107,0,0,0,0,20,0,117,2007
110,0,0,0,0,4,0,20,2007
112,0,0,0,0,4,0,39,2007
117,0,0,0,0,4,0,8,2007
118,0,0,0,0,4,0,34,2007
120,0,0,0,0,4,0,20,2007
122,0,0,0,0,8,0,41,2007
128,0,0,0,0,33,0,167,2007
133,0,0,0,0,12,0,86,2007
134,4,0,0,4,4,100,16,2007
140,0,0,0,0,84,0,473,2007
141,4,0,0,4,17,24,88,2007
142,0,0,0,0,9,0,36,2007
147,0,0,0,0,4,0,16,2007
1,1,0,0,1,6,17,29,2008
2,6,4,0,10,12,83,132,2008
201,3,0,0,3,8,38,110,2008
3,26,4,0,30,143,21,834,2008
301,4,0,0,4,65,6,309,2008
4,35,14,4,53,390,14,2701,2008
441,24,14,0,38,166,23,1084,2008
5,10,7,8,25,142,18,1146,2008
6,30,15,4,49,388,13,2608,2008
7,31,27,0,58,648,9,4895,2008
8,21,10,0,31,409,8,2697,2008
9,0,0,0,0,77,0,487,2008
10,10,0,0,10,16,63,138,2008
11,16,4,0,20,145,14,1021,2008
211,53,20,0,73,308,24,1838,2008
12,175,16,8,199,655,30,4480,2008
13,8,19,8,35,182,19,1380,2008
131,42,26,0,68,287,24,1617,2008
231,26,23,0,49,364,13,2594,2008
14,69,20,8,97,689,14,4505,2008
214,38,19,4,61,413,15,3236,2008
15,72,16,8,96,823,12,5640,2008
16,27,16,0,43,367,12,2650,2008
161,12,11,0,23,431,5,3092,2008
17,7,12,0,19,321,6,2228,2008
171,8,4,8,20,249,8,1698,2008
18,50,20,0,70,821,9,6177,2008
181,11,0,0,11,170,6,885,2008
19,16,10,10,36,433,8,3397,2008
191,0,0,0,0,106,0,649,2008
20,11,8,0,19,121,16,888,2008
21,69,31,0,100,508,20,4147,2008
22,27,8,0,35,309,11,2352,2008
23,26,4,4,34,289,12,1930,2008
24,46,24,0,70,544,13,3887,2008
25,19,8,0,27,310,9,1821,2008
26,15,20,0,35,344,10,2383,2008
27,18,8,0,26,364,7,2250,2008
28,50,7,4,61,607,10,4676,2008
29,5,2,0,7,38,18,403,2008
30,19,7,4,30,191,16,1207,2008
31,23,4,0,27,163,17,1122,2008
32,26,8,0,34,348,10,2492,2008
33,86,26,4,116,565,21,5131,2008
34,34,7,4,45,353,13,2735,2008
35,19,11,4,34,265,13,1549,2008
36,20,16,4,40,562,7,3593,2008
37,24,19,0,43,522,8,3678,2008
371,11,8,0,19,308,6,1937,2008
38,36,8,4,48,451,11,3092,2008
39,20,3,3,26,115,23,1020,2008
391,5,0,0,5,38,13,297,2008
40,60,5,0,65,111,59,1010,2008
41,31,0,7,38,300,13,2150,2008
411,12,4,0,16,150,11,711,2008
42,30,28,4,62,658,9,4497,2008
421,68,34,0,102,749,14,5120,2008
43,58,15,0,73,679,11,4860,2008
44,46,4,4,54,446,12,2966,2008
444,46,4,8,58,432,13,2897,2008
45,27,8,0,35,434,8,3472,2008
46,11,0,0,11,78,14,701,2008
461,4,0,0,4,52,8,456,2008
47,38,4,0,42,248,17,1640,2008
471,4,8,0,12,72,17,382,2008
48,8,0,0,8,151,5,1468,2008
481,13,2,0,15,94,16,919,2008
49,25,9,5,39,192,20,1727,2008
50,0,0,0,0,92,0,771,2008
500,9,8,0,17,131,13,1205,2008
501,17,4,0,21,100,21,1000,2008
51,6,3,0,9,87,10,852,2008
511,28,8,0,36,547,7,4027,2008
52,8,11,0,19,311,6,1983,2008
521,63,49,12,124,736,17,5235,2008
53,50,34,0,84,604,14,3914,2008
54,37,15,8,60,792,8,5439,2008
55,54,56,4,114,1078,11,7708,2008
551,19,4,0,23,363,6,2722,2008
56,6,8,0,14,120,12,1347,2008
561,4,7,0,11,86,13,663,2008
57,11,2,0,13,75,17,715,2008
58,12,0,0,12,67,18,532,2008
581,8,4,0,12,233,5,1854,2008
59,12,4,0,16,203,8,1203,2008
591,4,0,4,8,88,9,731,2008
60,7,0,0,7,58,12,337,2008
61,46,0,0,46,101,46,1048,2008
62,207,90,4,301,1941,16,15181,2008
63,30,23,4,57,272,21,2228,2008
64,22,0,0,22,194,11,1417,2008
65,61,27,0,88,572,15,3935,2008
66,55,0,0,55,237,23,2049,2008
67,9,0,0,9,83,11,660,2008
68,19,4,4,27,352,8,2502,2008
681,22,4,0,26,290,9,1790,2008
682,0,0,0,0,4,0,20,2008
69,3,0,0,3,69,4,587,2008
691,0,0,0,0,8,0,49,2008
70,84,37,0,121,800,15,5983,2008
71,72,60,0,132,985,13,7082,2008
711,46,19,4,69,393,18,2967,2008
72,0,4,0,4,217,2,2014,2008
73,11,30,0,41,271,15,1879,2008
74,68,15,0,83,746,11,5933,2008
741,4,0,0,4,75,5,528,2008
75,34,19,0,53,757,7,4904,2008
751,23,4,0,27,370,7,2491,2008
76,50,2,0,52,170,31,1543,2008
77,37,19,4,60,534,11,3875,2008
771,4,0,0,4,42,10,310,2008
78,61,16,4,81,610,13,4310,2008
79,12,0,0,12,279,4,1844,2008
80,15,8,0,23,697,3,5253,2008
81,86,42,4,132,919,14,7133,2008
82,23,0,0,23,321,7,1873,2008
83,31,0,4,35,111,32,963,2008
84,23,0,0,23,95,24,818,2008
85,50,8,0,58,499,12,3775,2008
851,26,0,0,26,99,26,668,2008
86,35,8,8,51,444,11,3250,2008
861,0,0,0,0,87,0,670,2008
87,4,0,0,4,11,36,78,2008
88,0,0,0,0,7,0,29,2008
89,0,0,0,0,4,0,16,2008
94,0,0,0,0,4,0,15,2008
99,0,0,0,0,4,0,11,2008
104,1,0,0,1,3,33,15,2008
107,0,4,0,4,4,100,21,2008
110,0,0,0,0,4,0,21,2008
128,4,0,0,4,64,6,341,2008
140,7,0,4,11,39,28,217,2008
1,1,0,0,1,1,100,6,2009
2,7,0,0,7,8,88,120,2009
201,8,0,0,8,8,100,66,2009
3,0,4,0,4,84,5,479,2009
301,7,0,0,7,28,25,175,2009
4,39,20,5,64,331,19,2353,2009
441,13,26,0,39,143,27,888,2009
5,19,15,3,37,155,24,905,2009
6,17,4,0,21,330,6,2263,2009
7,12,4,0,16,417,4,3287,2009
8,46,8,0,54,221,24,1495,2009
9,4,0,0,4,49,8,340,2009
10,10,0,0,10,15,67,197,2009
11,11,3,0,14,112,13,576,2009
211,55,22,0,77,213,36,1284,2009
12,113,27,3,143,567,25,3778,2009
13,8,22,0,30,186,16,1285,2009
131,21,15,4,40,250,16,1726,2009
231,42,20,4,66,374,18,2552,2009
14,85,36,0,121,609,20,4471,2009
214,25,43,0,68,339,20,2329,2009
15,95,30,3,128,728,18,5307,2009
16,25,15,0,40,362,11,2441,2009
161,21,10,0,31,359,9,2905,2009
17,0,4,3,7,243,3,1625,2009
171,3,7,4,14,259,5,1635,2009
18,40,22,0,62,815,8,6000,2009
181,3,0,0,3,153,2,875,2009
19,19,0,0,19,355,5,2754,2009
191,4,0,0,4,61,7,363,2009
20,20,8,0,28,108,26,1075,2009
21,39,12,0,51,356,14,2754,2009
22,33,20,3,56,306,18,2176,2009
23,66,37,7,110,384,29,2579,2009
24,81,7,0,88,497,18,3435,2009
25,23,3,3,29,258,11,1812,2009
26,14,3,0,17,208,8,1486,2009
27,3,7,4,14,266,5,1691,2009
28,36,22,4,62,541,11,3866,2009
29,2,0,0,2,30,7,292,2009
30,15,7,3,25,118,21,646,2009
31,27,3,4,34,174,20,1136,2009
32,25,4,0,29,306,9,1840,2009
33,102,0,0,102,580,18,5251,2009
34,11,3,0,14,258,5,1693,2009
35,11,15,3,29,288,10,1892,2009
36,32,12,0,44,493,9,3365,2009
37,46,26,0,72,414,17,2831,2009
371,3,7,0,10,235,4,1662,2009
38,4,10,0,14,353,4,2391,2009
39,13,2,0,15,79,19,705,2009
391,13,0,0,13,31,42,271,2009
40,49,0,0,49,84,58,833,2009
41,11,11,0,22,266,8,1796,2009
411,11,3,0,14,161,9,1034,2009
42,52,44,0,96,624,15,4125,2009
421,59,60,4,123,639,19,4724,2009
43,42,29,6,77,553,14,3713,2009
44,25,7,3,35,437,8,3184,2009
444,24,3,0,27,294,9,2333,2009
45,38,0,0,38,441,9,3266,2009
46,5,3,0,8,56,14,662,2009
461,14,0,0,14,48,29,449,2009
47,25,4,3,32,210,15,1503,2009
471,4,0,0,4,71,6,571,2009
48,20,6,0,26,145,18,1274,2009
481,18,0,0,18,98,18,837,2009
49,45,5,0,50,178,28,1703,2009
50,9,7,0,16,111,14,833,2009
500,10,5,0,15,126,12,1270,2009
501,12,4,0,16,82,20,791,2009
51,17,3,0,20,86,23,917,2009
511,12,15,7,34,680,5,5656,2009
52,15,7,0,22,275,8,1853,2009
521,77,33,10,120,589,20,4217,2009
53,42,10,7,59,509,12,3541,2009
54,31,29,0,60,660,9,4390,2009
55,46,23,6,75,832,9,5937,2009
551,7,22,3,32,315,10,2418,2009
56,4,10,0,14,118,12,1058,2009
561,4,0,0,4,95,4,1007,2009
57,16,0,0,16,65,25,550,2009
58,9,0,0,9,81,11,775,2009
581,8,11,0,19,289,7,2062,2009
59,0,7,3,10,179,6,1301,2009
591,4,0,0,4,51,8,542,2009
60,11,4,0,15,60,25,437,2009
61,41,0,0,41,81,51,893,2009
62,133,106,3,242,1705,14,13489,2009
63,28,7,3,38,281,14,2543,2009
64,10,0,0,10,136,7,876,2009
65,62,14,0,76,636,12,4222,2009
66,30,5,0,35,167,21,1413,2009
67,8,1,0,9,62,15,579,2009
68,7,3,0,10,310,3,2385,2009
681,11,0,0,11,230,5,1860,2009
69,9,0,0,9,53,17,482,2009
691,0,4,0,4,26,15,144,2009
70,68,52,13,133,793,17,5621,2009
71,52,55,0,107,911,12,6836,2009
711,38,17,0,55,357,15,2952,2009
72,10,0,3,13,151,9,1165,2009
73,10,22,0,32,248,13,2182,2009
74,35,38,7,80,578,14,4336,2009
741,7,3,3,13,65,20,436,2009
75,22,14,4,40,637,6,4368,2009
751,29,4,3,36,330,11,2298,2009
76,26,0,0,26,138,19,1161,2009
77,31,15,0,46,548,8,4434,2009
771,0,0,0,0,70,0,440,2009
78,65,17,0,82,768,11,5813,2009
79,20,0,0,20,156,13,1112,2009
80,42,17,3,62,657,9,5139,2009
81,47,35,3,85,933,9,6623,2009
82,22,8,4,34,338,10,2283,2009
83,17,3,0,20,96,21,604,2009
84,17,0,0,17,89,19,812,2009
85,80,7,0,87,553,16,3830,2009
851,2,0,0,2,97,2,828,2009
86,18,18,3,39,508,8,3779,2009
861,3,0,0,3,55,5,454,2009
88,0,0,0,0,7,0,52,2009
89,0,0,0,0,3,0,20,2009
91,0,0,0,0,14,0,138,2009
92,0,0,0,0,3,0,23,2009
94,0,0,0,0,3,0,17,2009
99,0,0,0,0,3,0,34,2009
101,0,0,0,0,14,0,108,2009
103,0,0,0,0,21,0,122,2009
104,0,0,0,0,10,0,59,2009
106,0,0,0,0,10,0,54,2009
107,0,0,0,0,35,0,147,2009
110,0,0,0,0,8,0,38,2009
115,0,0,0,0,4,0,18,2009
116,0,0,0,0,3,0,17,2009
117,0,0,0,0,3,0,7,2009
118,0,0,0,0,11,0,40,2009
121,3,0,0,3,7,43,18,2009
122,3,0,0,3,3,100,13,2009
123,0,0,0,0,3,0,17,2009
125,0,0,0,0,3,0,10,2009
128,0,0,0,0,30,0,185,2009
133,3,0,0,3,14,21,62,2009
134,7,0,0,7,17,41,81,2009
135,0,0,0,0,4,0,4,2009
140,3,0,0,3,67,4,420,2009
141,0,3,0,3,7,43,20,2009
143,0,0,0,0,7,0,34,2009
144,0,0,0,0,7,0,34,2009
147,0,0,0,0,4,0,4,2009
1,0,0,0,0,2,0,24,2010
2,10,0,0,10,12,83,128,2010
201,5,0,0,5,6,83,90,2010
3,4,0,0,4,72,6,527,2010
301,0,0,0,0,23,0,143,2010
4,27,23,4,54,292,18,2224,2010
441,37,22,4,63,203,31,1266,2010
5,29,7,0,36,188,19,1230,2010
6,36,4,4,44,455,10,3046,2010
7,32,10,0,42,366,11,3014,2010
8,3,10,0,13,427,3,3493,2010
9,3,0,0,3,32,9,142,2010
10,8,0,0,8,13,62,194,2010
11,22,11,0,33,200,17,1224,2010
211,79,25,0,104,288,36,1992,2010
12,111,35,0,146,586,25,4168,2010
13,47,15,0,62,225,28,1445,2010
131,22,24,0,46,359,13,2286,2010
231,33,22,0,55,551,10,3488,2010
14,97,23,11,131,1067,12,7466,2010
214,46,23,4,73,380,19,2391,2010
15,64,44,0,108,868,12,6301,2010
16,41,8,12,61,521,12,3550,2010
161,15,16,0,31,485,6,3567,2010
17,34,4,0,38,273,14,1488,2010
171,4,8,0,12,309,4,2072,2010
18,53,28,0,81,958,8,6937,2010
181,15,4,0,19,172,11,1203,2010
19,13,0,0,13,228,6,1724,2010
191,0,0,0,0,66,0,430,2010
20,18,5,2,25,78,32,600,2010
21,58,24,0,82,468,18,3431,2010
22,49,19,0,68,361,19,2439,2010
23,64,24,4,92,411,22,2343,2010
24,70,0,0,70,497,14,3545,2010
25,12,8,0,20,332,6,2098,2010
26,15,16,0,31,353,9,2197,2010
27,0,8,0,8,371,2,2510,2010
28,50,24,4,78,925,8,6783,2010
29,5,2,0,7,36,19,293,2010
30,15,4,0,19,165,12,935,2010
31,30,4,0,34,236,14,1472,2010
32,29,4,0,33,166,20,1046,2010
33,43,41,0,84,518,16,4362,2010
34,8,8,0,16,223,7,1429,2010
35,16,8,4,28,298,9,1724,2010
36,32,4,0,36,410,9,2584,2010
37,42,16,4,62,576,11,4254,2010
371,19,16,0,35,404,9,2558,2010
38,28,12,4,44,391,11,2396,2010
39,16,0,0,16,83,19,786,2010
391,7,0,0,7,23,30,244,2010
40,35,0,0,35,86,41,836,2010
41,22,8,4,34,265,13,1734,2010
411,16,8,0,24,192,13,1068,2010
42,47,26,0,73,693,11,5164,2010
421,50,56,4,110,838,13,6219,2010
43,61,12,4,77,801,10,5442,2010
44,23,12,0,35,499,7,3651,2010
444,26,8,0,34,401,8,2515,2010
45,16,24,0,40,600,7,4369,2010
46,13,0,0,13,57,23,595,2010
461,14,0,0,14,61,23,544,2010
47,19,0,0,19,226,8,1469,2010
471,0,0,0,0,122,0,728,2010
48,12,4,4,20,142,14,1232,2010
481,17,5,0,22,112,20,964,2010
49,20,2,0,22,181,12,1834,2010
50,4,0,0,4,102,4,787,2010
500,10,5,3,18,115,16,914,2010
501,11,2,0,13,89,15,851,2010
51,11,4,0,15,113,13,1178,2010
511,12,27,0,39,612,6,4753,2010
52,26,16,0,42,261,16,2009,2010
521,69,62,11,142,936,15,7141,2010
53,56,19,0,75,533,14,3828,2010
54,34,23,0,57,412,14,2919,2010
55,40,32,13,85,583,15,4554,2010
551,8,4,0,12,208,6,1920,2010
56,6,6,0,12,129,9,1321,2010
561,8,3,0,11,74,15,618,2010
57,2,7,0,9,62,15,429,2010
58,16,0,0,16,103,16,703,2010
581,0,0,0,0,294,0,1742,2010
59,4,4,0,8,232,3,1386,2010
591,4,0,0,4,87,5,783,2010
60,0,0,0,0,83,0,596,2010
61,34,6,0,40,122,33,1379,2010
62,156,57,16,229,1790,13,14857,2010
63,30,0,0,30,274,11,2288,2010
64,0,0,0,0,88,0,589,2010
65,41,16,0,57,597,10,4233,2010
66,17,6,0,23,184,13,1569,2010
67,8,7,0,15,78,19,665,2010
68,11,0,0,11,297,4,2125,2010
681,4,0,4,8,216,4,1775,2010
682,0,0,0,0,4,0,18,2010
69,10,0,0,10,113,9,1015,2010
691,0,4,0,4,37,11,209,2010
70,85,36,4,125,700,18,5312,2010
71,72,40,4,116,832,14,6162,2010
711,37,22,0,59,341,17,2338,2010
72,8,8,0,16,116,14,884,2010
73,18,15,4,37,278,13,2288,2010
74,40,20,4,64,709,9,5166,2010
741,22,0,0,22,83,27,511,2010
75,20,12,0,32,450,7,2881,2010
751,4,0,0,4,247,2,1803,2010
76,58,0,0,58,169,34,1731,2010
77,48,11,0,59,669,9,5164,2010
771,4,8,0,12,74,16,450,2010
78,89,36,0,125,834,15,5591,2010
79,7,4,0,11,155,7,1035,2010
791,0,0,0,0,8,0,26,2010
80,44,18,4,66,696,9,5437,2010
81,60,44,0,104,912,11,6402,2010
82,32,4,0,36,442,8,2799,2010
83,4,8,0,12,128,9,760,2010
84,8,0,0,8,120,7,982,2010
85,105,4,0,109,611,18,4939,2010
851,15,0,0,15,93,16,663,2010
86,25,15,4,44,532,8,3887,2010
861,12,8,0,20,100,20,662,2010
87,0,0,0,0,8,0,57,2010
88,0,0,0,0,4,0,21,2010
96,0,0,0,0,7,0,35,2010
98,0,0,0,0,4,0,32,2010
103,0,0,0,0,4,0,21,2010
104,2,0,0,2,8,25,49,2010
105,0,0,0,0,4,0,18,2010
111,0,0,0,0,8,0,74,2010
113,0,0,0,0,4,0,18,2010
114,0,0,0,0,7,0,63,2010
115,0,0,0,0,4,0,8,2010
117,0,0,0,0,4,0,8,2010
118,0,0,0,0,8,0,137,2010
125,0,0,0,0,4,0,4,2010
128,4,0,0,4,15,27,96,2010
130,0,0,0,0,4,0,25,2010
132,0,0,0,0,4,0,8,2010
133,4,0,0,4,11,36,46,2010
134,0,0,0,0,11,0,115,2010
136,0,0,0,0,8,0,83,2010
138,0,0,0,0,4,0,18,2010
140,20,0,0,20,70,29,435,2010
141,0,0,0,0,4,0,25,2010
142,0,0,0,0,4,0,4,2010
2,7,0,0,7,11,64,110,2011
201,5,0,0,5,8,63,131,2011
3,7,0,0,7,51,14,415,2011
301,6,0,0,6,39,15,251,2011
4,45,40,0,85,407,21,2732,2011
441,9,10,0,19,155,12,1021,2011
5,8,11,3,22,142,15,910,2011
6,19,27,0,46,487,9,3406,2011
7,22,0,3,25,299,8,2432,2011
8,24,0,0,24,318,8,2598,2011
9,3,0,0,3,49,6,197,2011
10,8,0,0,8,14,57,193,2011
11,31,6,0,37,197,19,1189,2011
211,76,21,4,101,249,41,1651,2011
12,74,30,13,117,567,21,3417,2011
13,28,10,0,38,206,18,1105,2011
131,29,20,4,53,425,12,2760,2011
231,31,22,8,61,536,11,3184,2011
14,32,36,0,68,977,7,6685,2011
214,36,8,6,50,478,10,3165,2011
15,74,29,0,103,825,12,5227,2011
16,30,18,0,48,447,11,2883,2011
161,33,10,7,50,488,10,3414,2011
17,33,0,0,33,279,12,1926,2011
171,19,7,3,29,292,10,2029,2011
18,33,14,3,50,981,5,6501,2011
181,18,7,0,25,195,13,1144,2011
19,15,0,0,15,269,6,1924,2011
191,0,0,0,0,98,0,414,2011
20,23,3,3,29,111,26,952,2011
21,81,18,0,99,460,22,3371,2011
22,69,23,12,104,395,26,2844,2011
23,78,24,9,111,557,20,3712,2011
24,57,18,0,75,461,16,3013,2011
25,23,17,0,40,295,14,1626,2011
26,25,3,10,38,261,15,1400,2011
27,13,9,8,30,394,8,2420,2011
28,28,14,8,50,888,6,6256,2011
29,7,0,0,7,31,23,310,2011
30,12,9,0,21,194,11,1102,2011
31,33,11,10,54,246,22,1483,2011
32,38,9,0,47,262,18,1669,2011
33,50,7,0,57,560,10,4613,2011
34,32,3,4,39,278,14,1695,2011
35,4,9,3,16,263,6,1362,2011
36,14,7,3,24,493,5,3159,2011
361,0,3,0,3,95,3,607,2011
37,41,7,0,48,630,8,4658,2011
371,26,7,4,37,405,9,2283,2011
38,18,11,0,29,384,8,2685,2011
39,11,0,0,11,100,11,833,2011
391,3,5,0,8,26,31,201,2011
40,35,0,0,35,86,41,937,2011
41,25,13,0,38,227,17,1621,2011
411,3,4,0,7,136,5,885,2011
42,97,27,0,124,607,20,4277,2011
421,76,39,3,118,660,18,4557,2011
43,67,22,4,93,827,11,5587,2011
44,24,7,0,31,454,7,3117,2011
444,24,10,0,34,311,11,1990,2011
45,22,10,7,39,516,8,3889,2011
46,3,0,0,3,51,6,517,2011
461,9,0,0,9,36,25,291,2011
47,16,0,0,16,250,6,1472,2011
471,4,7,4,15,98,15,569,2011
48,12,5,0,17,141,12,1313,2011
481,7,4,0,11,99,11,914,2011
49,15,4,4,23,163,14,1593,2011
50,0,0,0,0,99,0,802,2011
500,17,0,0,17,125,14,1346,2011
501,24,3,0,27,79,34,781,2011
51,4,4,0,8,94,9,881,2011
511,11,32,10,53,792,7,6091,2011
52,10,13,3,26,225,12,1554,2011
521,84,33,9,126,666,19,5071,2011
53,38,23,4,65,501,13,3628,2011
54,25,23,11,59,424,14,3588,2011
55,69,11,4,84,561,15,4950,2011
551,22,11,3,36,212,17,2074,2011
56,9,3,3,15,104,14,1108,2011
561,3,2,0,5,88,6,717,2011
57,17,0,0,17,88,19,829,2011
58,11,0,0,11,92,12,745,2011
581,13,4,4,21,370,6,2476,2011
59,17,3,3,23,276,8,1466,2011
591,0,0,4,4,102,4,682,2011
60,0,0,0,0,30,0,216,2011
61,37,0,0,37,76,49,1033,2011
62,136,85,6,227,1691,13,12763,2011
63,13,16,4,33,291,11,2081,2011
64,9,3,0,12,108,11,582,2011
65,65,19,4,88,554,16,3675,2011
66,25,5,0,30,171,18,1556,2011
67,10,4,0,14,72,19,703,2011
68,7,0,0,7,253,3,1791,2011
681,23,4,0,27,210,13,1550,2011
69,18,0,0,18,88,20,640,2011
691,0,0,0,0,34,0,279,2011
70,75,48,3,126,653,19,4628,2011
71,84,32,7,123,837,15,6124,2011
711,31,13,3,47,308,15,2151,2011
72,14,6,0,20,148,14,987,2011
73,31,4,6,41,269,15,1756,2011
74,51,12,4,67,636,11,5022,2011
741,6,0,0,6,94,6,572,2011
75,24,0,0,24,446,5,3143,2011
751,30,0,4,34,256,13,1660,2011
76,40,2,0,42,148,28,1234,2011
77,21,15,0,36,465,8,3220,2011
771,13,0,0,13,85,15,461,2011
78,61,22,7,90,676,13,4595,2011
79,4,0,0,4,126,3,976,2011
791,0,0,0,0,3,0,24,2011
80,16,18,4,38,691,5,4814,2011
81,69,32,3,104,885,12,6536,2011
82,19,4,0,23,398,6,2489,2011
83,10,3,0,13,150,9,962,2011
84,14,0,5,19,77,25,606,2011
85,53,38,0,91,689,13,4922,2011
851,23,0,0,23,128,18,775,2011
86,24,7,4,35,610,6,4207,2011
861,14,0,0,14,144,10,1059,2011
87,0,0,0,0,3,0,30,2011
93,0,0,0,0,6,0,30,2011
94,3,0,0,3,6,50,30,2011
95,3,0,0,3,3,100,12,2011
98,0,0,0,0,4,0,7,2011
99,3,0,0,3,3,100,3,2011
103,0,0,0,0,3,0,15,2011
104,0,0,0,0,12,0,80,2011
110,3,0,0,3,9,33,82,2011
112,0,0,0,0,7,0,26,2011
116,0,0,0,0,6,0,54,2011
117,0,0,0,0,3,0,21,2011
118,3,0,0,3,10,30,76,2011
125,0,0,0,0,3,0,21,2011
126,0,0,0,0,3,0,36,2011
127,0,0,0,0,3,0,18,2011
128,0,0,0,0,7,0,19,2011
129,0,0,0,0,4,0,15,2011
133,0,0,0,0,9,0,60,2011
134,7,0,0,7,34,21,154,2011
136,0,0,0,0,3,0,21,2011
140,25,3,0,28,88,32,591,2011
141,3,0,0,3,10,30,75,2011
142,0,0,0,0,4,0,4,2011
143,0,0,0,0,4,0,11,2011
146,0,0,0,0,4,0,25,2011
1,1,0,0,1,2,50,33,2012
2,7,0,0,7,8,88,102,2012
201,5,0,0,5,8,63,95,2012
3,0,0,0,0,49,0,258,2012
301,3,0,0,3,20,15,77,2012
4,32,25,6,63,374,17,2508,2012
441,36,16,0,52,184,28,1034,2012
5,6,12,0,18,120,15,832,2012
6,27,10,7,44,538,8,3395,2012
7,24,3,0,27,375,7,2613,2012
8,14,5,0,19,252,8,1999,2012
9,0,0,0,0,46,0,453,2012
10,4,0,0,4,14,29,160,2012
11,24,14,0,38,187,20,1199,2012
211,37,12,3,52,312,17,1957,2012
12,112,24,3,139,545,26,3580,2012
13,38,13,3,54,175,31,1056,2012
131,71,20,3,94,401,23,3048,2012
231,26,4,4,34,475,7,3493,2012
14,88,44,0,132,1071,12,7786,2012
214,55,27,4,86,437,20,2681,2012
15,52,14,7,73,908,8,6542,2012
16,50,13,0,63,483,13,3244,2012
161,35,17,0,52,570,9,3795,2012
17,26,7,0,33,327,10,2138,2012
171,19,18,0,37,332,11,2237,2012
18,29,19,0,48,1012,5,6908,2012
181,10,6,0,16,157,10,922,2012
19,19,0,0,19,283,7,1715,2012
191,11,0,0,11,69,16,491,2012
20,26,2,0,28,115,24,831,2012
21,44,29,3,76,533,14,4198,2012
22,22,18,0,40,427,9,2994,2012
23,76,10,0,86,527,16,3107,2012
24,81,7,0,88,406,22,2745,2012
25,16,10,0,26,351,7,2237,2012
26,26,3,0,29,346,8,2364,2012
27,17,3,0,20,318,6,1899,2012
28,34,23,3,60,869,7,6003,2012
29,8,0,0,8,28,29,266,2012
30,4,10,0,14,253,6,1517,2012
31,34,7,4,45,208,22,1281,2012
32,28,17,0,45,195,23,1167,2012
33,71,11,0,82,582,14,4868,2012
34,27,7,0,34,275,12,1953,2012
35,21,0,0,21,316,7,2149,2012
36,35,13,0,48,454,11,2706,2012
361,7,0,0,7,75,9,502,2012
37,10,13,0,23,630,4,3775,2012
371,28,0,6,34,384,9,2420,2012
38,29,0,4,33,415,8,3164,2012
39,15,3,0,18,91,20,788,2012
391,5,3,0,8,34,24,256,2012
40,28,0,0,28,66,42,670,2012
41,32,10,4,46,233,20,1538,2012
411,4,0,0,4,156,3,1051,2012
42,46,49,3,98,615,16,4643,2012
421,63,56,4,123,693,18,5027,2012
43,69,41,3,113,898,13,6511,2012
44,17,7,0,24,463,5,3152,2012
444,10,7,0,17,283,6,1805,2012
45,13,0,7,20,573,3,4423,2012
46,2,0,0,2,52,4,572,2012
461,0,0,0,0,45,0,456,2012
47,10,7,0,17,218,8,1493,2012
471,7,0,0,7,90,8,382,2012
48,15,2,6,23,115,20,943,2012
481,11,7,0,18,95,19,965,2012
49,42,12,0,54,160,34,1586,2012
50,4,0,0,4,97,4,934,2012
500,9,0,0,9,121,7,1042,2012
501,4,3,0,7,76,9,780,2012
51,3,3,0,6,82,7,719,2012
511,22,24,3,49,724,7,6027,2012
52,13,10,0,23,206,11,1180,2012
521,77,39,0,116,711,16,5424,2012
53,59,13,0,72,530,14,3863,2012
54,41,15,0,56,409,14,3253,2012
55,40,43,0,83,622,13,5039,2012
551,25,4,4,33,217,15,1890,2012
56,0,4,0,4,117,3,1053,2012
561,8,10,0,18,82,22,763,2012
57,5,0,5,10,76,13,693,2012
58,19,2,0,21,107,20,947,2012
581,16,10,0,26,433,6,2960,2012
59,7,7,0,14,219,6,1304,2012
591,4,0,0,4,80,5,550,2012
60,4,0,0,4,66,6,629,2012
61,37,0,0,37,79,47,1032,2012
62,155,81,10,246,1825,13,14685,2012
63,23,4,0,27,211,13,1451,2012
64,13,3,0,16,87,18,579,2012
65,62,19,0,81,611,13,4304,2012
66,34,7,0,41,174,24,1393,2012
67,11,2,0,13,55,24,545,2012
68,21,4,0,25,287,9,1986,2012
681,19,0,0,19,251,8,1705,2012
69,18,7,0,25,83,30,581,2012
691,0,0,0,0,14,0,115,2012
70,80,41,0,121,597,20,4062,2012
71,71,37,0,108,844,13,6546,2012
711,16,10,4,30,244,12,1753,2012
72,15,0,0,15,98,15,751,2012
73,16,10,0,26,219,12,1641,2012
74,79,9,0,88,598,15,4481,2012
741,6,3,0,9,52,17,405,2012
75,43,6,0,49,394,12,2720,2012
751,23,0,0,23,274,8,1583,2012
76,41,2,0,43,132,33,1172,2012
77,71,13,0,84,565,15,3813,2012
771,7,0,0,7,64,11,283,2012
78,104,21,0,125,822,15,5864,2012
79,3,0,0,3,117,3,734,2012
791,0,0,0,0,4,0,20,2012
80,59,9,3,71,619,11,4176,2012
81,99,40,4,143,970,15,7203,2012
82,29,12,0,41,419,10,2526,2012
83,29,0,0,29,139,21,1039,2012
84,21,11,0,32,97,33,851,2012
85,71,6,4,81,567,14,3826,2012
851,23,7,0,30,108,28,675,2012
86,34,7,4,45,540,8,3672,2012
861,4,0,0,4,138,3,879,2012
87,0,0,0,0,7,0,29,2012
88,3,0,0,3,6,50,42,2012
89,0,0,4,4,4,100,22,2012
95,0,0,0,0,3,0,33,2012
96,0,3,0,3,3,100,21,2012
97,0,0,0,0,3,0,45,2012
98,0,0,0,0,3,0,24,2012
99,0,0,0,0,4,0,4,2012
104,2,0,0,2,9,22,81,2012
106,0,0,0,0,7,0,10,2012
112,0,0,0,0,4,0,25,2012
116,0,0,0,0,6,0,58,2012
117,0,0,0,0,7,0,54,2012
118,0,0,0,0,6,0,73,2012
123,3,0,0,3,3,100,9,2012
124,0,0,0,0,3,0,30,2012
127,0,0,0,0,4,0,18,2012
128,0,0,0,0,14,0,95,2012
129,0,0,0,0,4,0,11,2012
133,3,0,0,3,10,30,34,2012
134,0,0,0,0,12,0,64,2012
135,0,0,0,0,3,0,18,2012
136,0,0,0,0,4,0,4,2012
140,13,7,0,20,127,16,695,2012
141,0,3,0,3,13,23,163,2012
142,0,0,0,0,17,0,35,2012
147,0,0,0,0,3,0,24,2012
2,7,0,0,7,7,100,45,2013
201,6,0,0,6,8,75,103,2013
3,10,4,0,14,74,19,505,2013
301,0,0,0,0,13,0,106,2013
4,61,44,3,108,352,31,2628,2013
441,15,13,0,28,140,20,818,2013
5,38,12,0,50,140,36,997,2013
6,29,7,0,36,542,7,3543,2013
7,29,0,0,29,180,16,1569,2013
8,27,0,0,27,104,26,513,2013
9,0,0,0,0,37,0,137,2013
10,10,0,0,10,15,67,178,2013
11,27,7,0,34,200,17,1119,2013
211,50,13,0,63,256,25,1476,2013
12,108,26,8,142,610,23,4195,2013
13,19,21,0,40,271,15,1535,2013
131,47,23,0,70,331,21,2553,2013
231,38,18,0,56,546,10,3539,2013
14,58,37,10,105,1000,11,7074,2013
214,70,37,3,110,516,21,3320,2013
15,55,30,0,85,1020,8,6847,2013
16,51,12,15,78,543,14,3193,2013
161,67,13,13,93,665,14,4738,2013
17,21,16,3,40,419,10,2731,2013
171,24,14,7,45,386,12,2510,2013
18,33,24,4,61,1094,6,7533,2013
181,3,3,4,10,217,5,1086,2013
19,9,0,0,9,107,8,495,2013
191,0,0,0,0,25,0,149,2013
20,18,7,0,25,29,86,204,2013
21,47,14,0,61,543,11,4339,2013
22,50,6,0,56,358,16,2885,2013
23,45,38,0,83,471,18,3234,2013
24,23,18,0,41,428,10,2959,2013
25,36,4,0,40,401,10,2644,2013
26,15,4,0,19,328,6,1910,2013
27,22,7,0,29,396,7,2591,2013
28,51,10,3,64,985,6,6370,2013
29,6,3,0,9,11,82,101,2013
30,19,3,0,22,204,11,1101,2013
31,46,7,0,53,267,20,1662,2013
32,19,6,0,25,204,12,1428,2013
33,45,7,0,52,519,10,3745,2013
34,24,4,3,31,312,10,2170,2013
35,13,16,0,29,313,9,1930,2013
36,30,3,0,33,504,7,3394,2013
361,3,0,0,3,68,4,362,2013
37,31,24,3,58,781,7,5161,2013
371,6,10,0,16,418,4,2689,2013
38,7,15,0,22,381,6,2305,2013
39,23,0,0,23,91,25,930,2013
391,7,2,0,9,27,33,300,2013
40,47,0,0,47,68,69,641,2013
41,31,23,4,58,354,16,2392,2013
411,13,3,0,16,170,9,1181,2013
42,115,38,4,157,820,19,5791,2013
421,61,47,21,129,958,13,7228,2013
43,96,21,0,117,857,14,5783,2013
44,21,7,0,28,442,6,2912,2013
444,19,10,0,29,335,9,1894,2013
45,31,20,3,54,585,9,4215,2013
46,12,0,0,12,56,21,402,2013
461,0,0,0,0,38,0,443,2013
47,27,4,0,31,271,11,1817,2013
471,14,4,0,18,145,12,834,2013
48,7,7,3,17,130,13,1446,2013
481,10,4,0,14,84,17,789,2013
49,10,5,3,18,159,11,1703,2013
50,7,4,0,11,98,11,953,2013
500,7,6,0,13,126,10,1096,2013
501,16,8,0,24,71,34,633,2013
51,1,0,0,1,79,1,819,2013
511,43,24,4,71,865,8,6255,2013
52,16,21,4,41,318,13,2061,2013
521,102,50,7,159,868,18,6157,2013
53,78,6,10,94,591,16,4244,2013
54,40,6,0,46,393,12,2844,2013
55,52,54,8,114,606,19,5684,2013
551,23,2,0,25,190,13,1708,2013
56,7,3,0,10,98,10,1030,2013
561,7,7,0,14,75,19,739,2013
57,14,0,0,14,86,16,983,2013
58,7,3,3,13,93,14,858,2013
581,7,14,0,21,366,6,2455,2013
59,13,11,0,24,288,8,1590,2013
591,4,0,0,4,135,3,666,2013
60,22,0,0,22,53,42,429,2013
61,31,0,0,31,91,34,1090,2013
62,134,70,9,213,1638,13,13449,2013
63,33,26,3,62,296,21,2096,2013
64,6,12,4,22,109,20,747,2013
65,55,19,3,77,632,12,4192,2013
66,34,4,0,38,160,24,1329,2013
67,14,0,0,14,60,23,704,2013
68,24,0,0,24,277,9,2209,2013
681,11,4,0,15,234,6,1562,2013
682,0,0,0,0,3,0,17,2013
69,6,0,0,6,50,12,360,2013
691,0,4,0,4,49,8,369,2013
70,90,55,6,151,712,21,5144,2013
71,110,33,6,149,839,18,6019,2013
711,37,6,0,43,248,17,1740,2013
72,13,0,0,13,87,15,632,2013
73,10,13,7,30,221,14,1773,2013
74,52,24,4,80,666,12,5164,2013
741,7,0,0,7,60,12,448,2013
75,24,10,0,34,404,8,2743,2013
751,30,11,0,41,284,14,1980,2013
76,63,4,0,67,131,51,1211,2013
77,44,13,3,60,412,15,3231,2013
771,7,0,0,7,79,9,558,2013
78,98,13,0,111,716,16,4984,2013
79,3,0,0,3,128,2,700,2013
791,0,0,0,0,3,0,10,2013
80,81,9,7,97,746,13,5377,2013
81,98,49,3,150,1031,15,7574,2013
82,52,10,0,62,430,14,2679,2013
83,42,10,3,55,228,24,1418,2013
84,24,0,0,24,121,20,1074,2013
85,104,20,8,132,740,18,5574,2013
851,27,0,0,27,109,25,836,2013
86,48,24,0,72,665,11,4663,2013
861,11,0,0,11,171,6,1223,2013
87,0,4,0,4,24,17,169,2013
88,3,0,0,3,6,50,49,2013
89,0,0,0,0,6,0,22,2013
94,0,0,0,0,3,0,12,2013
96,0,0,0,0,4,0,65,2013
97,0,0,0,0,3,0,15,2013
102,0,0,0,0,4,0,11,2013
104,0,0,0,0,7,0,37,2013
106,0,0,0,0,3,0,15,2013
110,0,0,0,0,9,0,46,2013
114,0,0,0,0,4,0,22,2013
115,0,0,0,0,3,0,18,2013
116,0,0,0,0,7,0,41,2013
119,0,0,4,4,4,100,25,2013
121,0,0,0,0,4,0,18,2013
124,0,0,0,0,4,0,15,2013
128,0,0,0,0,13,0,69,2013
130,0,0,0,0,4,0,36,2013
133,0,3,0,3,20,15,89,2013
134,6,0,0,6,12,50,71,2013
137,3,0,0,3,7,43,33,2013
139,0,0,0,0,3,0,18,2013
140,32,13,0,45,196,23,1304,2013
141,9,0,0,9,41,22,239,2013
142,0,0,0,0,11,0,76,2013
144,0,0,0,0,4,0,4,2013
146,0,0,0,0,3,0,15,2013
1,0,0,0,0,1,0,4,2014
2,8,0,0,8,8,100,117,2014
201,8,0,0,8,8,100,62,2014
3,16,0,0,16,112,14,458,2014
301,0,0,0,0,89,0,529,2014
4,30,40,0,70,383,18,2680,2014
441,4,16,16,36,227,16,1612,2014
5,27,5,5,37,131,28,910,2014
6,70,40,0,110,815,13,5317,2014
7,31,42,10,83,376,22,3268,2014
8,31,31,0,62,280,22,1922,2014
9,10,0,0,10,39,26,110,2014
10,13,0,0,13,15,87,230,2014
11,8,3,0,11,204,5,1274,2014
211,16,7,0,23,224,10,1609,2014
12,113,21,9,143,629,23,4754,2014
13,47,4,0,51,235,22,1391,2014
131,51,7,0,58,471,12,3633,2014
231,47,8,3,58,491,12,3113,2014
14,142,77,4,223,1276,17,9740,2014
214,35,3,0,38,450,8,2721,2014
15,112,53,0,165,988,17,7774,2014
16,51,60,3,114,533,21,3672,2014
161,40,50,0,90,779,12,5069,2014
17,24,7,0,31,424,7,2899,2014
171,31,3,0,34,401,8,2594,2014
18,15,11,3,29,1065,3,7955,2014
181,20,4,0,24,233,10,1249,2014
19,18,0,0,18,176,10,1288,2014
191,21,0,0,21,117,18,824,2014
20,10,5,3,18,102,18,1119,2014
21,81,22,0,103,412,25,2863,2014
22,85,7,17,109,435,25,3256,2014
23,67,16,0,83,454,18,2794,2014
24,38,12,0,50,333,15,2544,2014
25,8,27,3,38,248,15,1719,2014
26,40,0,0,40,215,19,1278,2014
27,58,7,0,65,384,17,2089,2014
28,23,27,8,58,1127,5,7481,2014
29,3,1,0,4,30,13,271,2014
30,0,0,0,0,139,0,777,2014
31,43,4,16,63,223,28,1778,2014
32,8,3,0,11,299,4,1762,2014
33,107,30,16,153,782,20,6046,2014
34,51,4,4,59,298,20,2269,2014
35,24,11,0,35,341,10,2000,2014
36,19,11,0,30,490,6,3012,2014
361,0,0,0,0,107,0,1027,2014
37,38,14,14,66,664,10,4319,2014
371,23,16,0,39,509,8,3566,2014
38,19,8,0,27,472,6,3314,2014
39,23,4,0,27,90,30,695,2014
391,5,0,0,5,24,21,149,2014
40,38,0,0,38,74,51,693,2014
41,24,22,0,46,359,13,2581,2014
411,11,8,4,23,217,11,1599,2014
42,112,53,3,168,889,19,6634,2014
421,93,38,11,142,980,14,7288,2014
43,35,15,0,50,638,8,4467,2014
44,43,8,4,55,405,14,2726,2014
444,15,3,0,18,299,6,2149,2014
45,35,3,0,38,591,6,4364,2014
46,3,0,0,3,48,6,422,2014
461,8,0,0,8,36,22,284,2014
47,20,0,0,20,269,7,1905,2014
471,4,3,0,7,132,5,785,2014
48,15,0,0,15,92,16,850,2014
481,6,3,0,9,84,11,710,2014
49,36,13,4,53,166,32,1910,2014
50,20,0,0,20,93,22,583,2014
500,17,4,0,21,127,17,1292,2014
501,15,4,0,19,84,23,1045,2014
51,11,0,0,11,94,12,952,2014
511,19,43,11,73,876,8,7222,2014
52,43,0,0,43,426,10,3183,2014
521,69,28,3,100,788,13,6049,2014
53,46,77,0,123,680,18,5079,2014
54,44,29,0,73,404,18,3449,2014
55,36,24,8,68,610,11,5373,2014
551,15,12,0,27,195,14,1921,2014
56,0,0,0,0,90,0,1033,2014
561,11,11,0,22,59,37,600,2014
57,21,3,0,24,92,26,662,2014
58,24,0,0,24,102,24,1032,2014
581,11,7,0,18,349,5,2500,2014
59,24,0,0,24,307,8,2062,2014
591,4,0,0,4,126,3,875,2014
60,24,0,0,24,97,25,771,2014
61,45,0,0,45,100,45,1115,2014
62,226,42,4,272,1621,17,13104,2014
63,24,27,20,71,271,26,2158,2014
64,20,0,0,20,152,13,980,2014
65,90,11,0,101,900,11,6448,2014
66,20,4,0,24,149,16,1260,2014
67,21,2,0,23,60,38,575,2014
68,27,24,4,55,334,16,2828,2014
681,11,0,0,11,269,4,2319,2014
682,0,6,0,6,15,40,23,2014
69,19,0,0,19,87,22,788,2014
691,4,0,0,4,30,13,226,2014
70,138,35,4,177,776,23,5330,2014
71,106,43,16,165,818,20,6273,2014
711,15,8,0,23,293,8,2979,2014
72,24,0,0,24,144,17,824,2014
73,24,11,4,39,274,14,1782,2014
74,86,8,0,94,726,13,5189,2014
741,20,4,0,24,104,23,700,2014
75,27,36,0,63,441,14,3185,2014
751,39,8,0,47,346,14,2815,2014
76,50,0,0,50,133,38,1403,2014
77,67,4,0,71,544,13,3579,2014
771,16,0,0,16,124,13,750,2014
78,115,20,0,135,593,23,4365,2014
79,20,0,0,20,211,9,1386,2014
791,0,7,0,7,18,39,19,2014
80,125,20,4,149,857,17,6578,2014
81,145,81,16,242,1205,20,8999,2014
82,15,15,0,30,347,9,2365,2014
83,0,8,0,8,272,3,2825,2014
84,23,9,0,32,92,35,987,2014
85,96,18,20,134,605,22,4519,2014
851,46,0,0,46,115,40,896,2014
86,35,11,0,46,647,7,4939,2014
861,0,7,0,7,113,6,796,2014
87,0,0,0,0,16,0,95,2014
88,0,0,0,0,4,0,80,2014
89,0,0,0,0,32,0,443,2014
94,0,0,0,0,16,0,79,2014
951,0,0,0,0,8,0,23,2014
100,0,0,0,0,4,0,15,2014
104,0,0,0,0,4,0,18,2014
105,4,0,0,4,4,100,11,2014
106,0,0,0,0,4,0,23,2014
110,0,0,0,0,43,0,204,2014
111,0,0,0,0,4,0,19,2014
112,0,0,0,0,4,0,8,2014
115,0,0,0,0,4,0,11,2014
116,0,0,0,0,4,0,61,2014
117,0,0,0,0,4,0,19,2014
118,0,0,0,0,11,0,49,2014
123,0,4,0,4,4,100,23,2014
128,0,0,0,0,11,0,49,2014
133,0,0,0,0,16,0,47,2014
134,0,0,0,0,20,0,144,2014
140,36,4,0,40,232,17,1564,2014
141,0,0,4,4,31,13,232,2014
142,0,0,0,0,14,0,75,2014
147,4,0,0,4,20,20,125,2014
1,1,0,0,1,2,50,32,2015
2,4,0,0,4,8,50,82,2015
201,5,0,0,5,7,71,99,2015
3,13,0,0,13,87,15,485,2015
301,0,0,0,0,34,0,186,2015
4,43,19,3,65,383,17,2426,2015
441,22,30,0,52,158,33,1089,2015
5,18,10,0,28,138,20,884,2015
6,34,23,0,57,749,8,5202,2015
7,37,3,0,40,419,10,2971,2015
8,22,9,0,31,271,11,2167,2015
9,6,0,0,6,46,13,292,2015
10,14,0,0,14,14,100,127,2015
11,50,7,0,57,239,24,1805,2015
211,56,14,0,70,328,21,2325,2015
12,132,26,5,163,582,28,3770,2015
13,20,23,0,43,248,17,1426,2015
131,37,17,0,54,420,13,2871,2015
231,32,7,3,42,575,7,3486,2015
14,92,37,4,133,1243,11,8822,2015
214,72,37,7,116,616,19,4285,2015
15,77,29,0,106,1105,10,8051,2015
16,45,34,4,83,531,16,3488,2015
161,49,21,0,70,764,9,5699,2015
17,13,6,4,23,426,5,2516,2015
171,17,17,10,44,474,9,3338,2015
18,47,14,10,71,1196,6,8039,2015
181,4,0,0,4,257,2,1594,2015
19,15,0,0,15,218,7,1805,2015
191,9,0,0,9,46,20,267,2015
20,15,2,0,17,103,17,1054,2015
21,37,29,4,70,500,14,3772,2015
22,62,18,4,84,373,23,2881,2015
23,61,32,0,93,388,24,2500,2015
24,76,28,0,104,568,18,4016,2015
25,14,0,0,14,303,5,1987,2015
26,20,7,0,27,337,8,2001,2015
27,13,10,3,26,428,6,2604,2015
28,45,33,3,81,1251,6,8782,2015
29,2,0,0,2,28,7,353,2015
30,10,7,0,17,188,9,1217,2015
31,31,12,4,47,235,20,1882,2015
32,47,4,0,51,208,25,1301,2015
33,31,25,0,56,490,11,3976,2015
34,23,3,3,29,312,9,1894,2015
35,17,11,4,32,264,12,1528,2015
36,17,20,4,41,545,8,3766,2015
361,0,0,0,0,120,0,715,2015
37,27,7,4,38,800,5,5062,2015
371,30,3,3,36,476,8,2939,2015
38,21,14,0,35,496,7,2982,2015
39,10,4,0,14,75,19,684,2015
391,0,0,3,3,37,8,349,2015
40,40,0,0,40,74,54,932,2015
41,29,16,4,49,406,12,2930,2015
411,21,6,0,27,169,16,927,2015
42,89,57,7,153,918,17,6671,2015
421,101,41,10,152,966,16,6796,2015
43,66,22,0,88,945,9,6895,2015
44,20,4,0,24,361,7,2178,2015
444,37,7,0,44,329,13,2188,2015
45,21,7,4,32,550,6,3996,2015
46,2,0,0,2,52,4,313,2015
461,11,0,0,11,39,28,371,2015
47,13,10,0,23,225,10,1782,2015
471,7,10,0,17,145,12,876,2015
48,15,3,0,18,90,20,813,2015
481,9,0,0,9,88,10,768,2015
49,26,6,3,35,148,24,1447,2015
50,10,3,3,16,104,15,1150,2015
500,13,5,0,18,114,16,959,2015
501,15,2,0,17,68,25,691,2015
51,15,0,0,15,70,21,649,2015
511,11,27,7,45,811,6,5804,2015
52,16,14,0,30,413,7,2497,2015
521,118,36,0,154,992,16,7037,2015
53,70,34,0,104,715,15,5305,2015
54,32,9,0,41,362,11,3151,2015
55,29,16,9,54,542,10,4758,2015
551,41,3,0,44,211,21,1785,2015
56,5,0,0,5,93,5,838,2015
561,2,2,0,4,60,7,615,2015
57,15,0,0,15,92,16,790,2015
58,14,0,0,14,86,16,962,2015
581,11,4,0,15,490,3,2685,2015
59,14,6,4,24,290,8,1877,2015
591,10,0,0,10,106,9,662,2015
60,13,0,0,13,73,18,453,2015
61,42,0,0,42,91,46,1011,2015
62,162,77,0,239,1639,15,12601,2015
63,24,16,3,43,276,16,2026,2015
64,10,3,0,13,141,9,850,2015
65,59,32,4,95,760,13,5407,2015
66,39,3,0,42,137,31,1244,2015
67,7,2,0,9,59,15,467,2015
68,20,0,0,20,328,6,2417,2015
681,20,0,0,20,275,7,1964,2015
682,0,0,0,0,3,0,19,2015
69,10,6,0,16,86,19,588,2015
691,0,0,0,0,23,0,94,2015
70,52,23,10,85,722,12,5546,2015
71,95,56,6,157,1027,15,7891,2015
711,26,6,4,36,340,11,2530,2015
72,9,0,0,9,129,7,995,2015
73,33,4,0,37,273,14,2012,2015
74,79,17,4,100,779,13,5818,2015
741,20,6,0,26,109,24,906,2015
75,42,10,4,56,508,11,3701,2015
751,32,0,0,32,358,9,2315,2015
76,55,0,0,55,139,40,1500,2015
77,55,23,0,78,635,12,4724,2015
771,13,0,0,13,123,11,770,2015
78,118,29,6,153,976,16,6967,2015
79,7,0,0,7,147,5,904,2015
791,0,0,0,0,7,0,86,2015
80,105,16,4,125,1004,12,7861,2015
81,134,69,14,217,1322,16,9787,2015
82,27,13,0,40,507,8,3584,2015
83,16,4,0,20,244,8,1832,2015
84,17,0,0,17,89,19,914,2015
85,81,13,15,109,937,12,6574,2015
851,25,0,0,25,148,17,1082,2015
86,20,13,0,33,632,5,4678,2015
861,13,0,0,13,173,8,1185,2015
87,3,0,0,3,17,18,112,2015
88,0,0,0,0,10,0,68,2015
89,0,0,0,0,4,0,7,2015
90,0,0,0,0,3,0,19,2015
91,0,0,0,0,4,0,28,2015
92,0,0,0,0,3,0,16,2015
94,0,0,0,0,4,0,18,2015
101,0,4,0,4,4,100,14,2015
102,0,0,0,0,3,0,16,2015
103,0,0,0,0,3,0,19,2015
104,2,0,0,2,11,18,84,2015
111,0,0,0,0,4,0,42,2015
112,0,0,0,0,4,0,18,2015
114,4,0,0,4,7,57,46,2015
117,0,0,0,0,4,0,18,2015
118,0,0,0,0,20,0,112,2015
119,4,0,0,4,4,100,35,2015
120,0,0,0,0,4,0,11,2015
121,0,0,0,0,14,0,37,2015
124,0,0,0,0,3,0,63,2015
128,6,0,0,6,27,22,155,2015
129,0,0,0,0,3,0,38,2015
132,0,0,0,0,3,0,19,2015
133,0,0,0,0,20,0,128,2015
134,3,0,0,3,6,50,25,2015
136,0,0,0,0,7,0,56,2015
137,0,0,0,0,7,0,35,2015
138,0,0,0,0,4,0,18,2015
140,32,4,0,36,161,22,1154,2015
141,4,0,0,4,17,24,116,2015
142,0,0,0,0,7,0,21,2015
144,0,0,0,0,3,0,25,2015
145,0,0,0,0,3,0,28,2015
147,0,0,0,0,4,0,18,2015
1,2,0,0,2,2,100,24,2016
2,5,0,0,5,10,50,129,2016
201,8,0,0,8,9,89,147,2016
3,0,0,0,0,78,0,519,2016
301,7,3,0,10,62,16,368,2016
4,54,31,6,91,387,24,2533,2016
441,23,14,0,37,168,22,1179,2016
5,17,11,0,28,152,18,1087,2016
6,27,37,3,67,840,8,5382,2016
7,21,0,0,21,404,5,3318,2016
8,10,21,10,41,325,13,2786,2016
9,4,0,0,4,25,16,125,2016
10,12,0,0,12,14,86,117,2016
11,20,10,0,30,228,13,1256,2016
211,51,10,3,64,293,22,2249,2016
12,122,58,10,190,652,29,4130,2016
13,31,24,3,58,261,22,1539,2016
131,44,37,0,81,396,20,2473,2016
231,44,27,6,77,719,11,4531,2016
14,102,27,7,136,1285,11,9140,2016
214,44,17,3,64,496,13,3168,2016
15,31,13,4,48,1045,5,7615,2016
16,37,38,9,84,755,11,4873,2016
161,24,10,0,34,335,10,2140,2016
17,16,7,3,26,454,6,2938,2016
171,17,13,0,30,559,5,3756,2016
18,44,20,0,64,1159,6,7472,2016
181,20,7,3,30,243,12,1414,2016
19,21,0,0,21,209,10,1388,2016
191,0,0,0,0,63,0,666,2016
20,16,4,0,20,108,19,972,2016
21,47,28,0,75,480,16,3573,2016
22,40,13,0,53,420,13,2942,2016
23,100,25,0,125,487,26,3166,2016
24,53,26,0,79,507,16,3478,2016
25,20,10,0,30,349,9,2217,2016
26,13,10,0,23,412,6,2577,2016
27,30,0,0,30,465,6,2662,2016
28,60,13,0,73,1219,6,8947,2016
29,9,2,0,11,30,37,279,2016
30,10,0,0,10,159,6,1006,2016
31,31,6,0,37,234,16,1512,2016
32,17,10,0,27,261,10,1759,2016
33,35,25,0,60,599,10,3950,2016
34,17,7,0,24,382,6,2592,2016
35,7,0,0,7,285,2,1854,2016
36,10,17,3,30,561,5,3593,2016
361,0,0,0,0,92,0,537,2016
37,31,13,3,47,853,6,5172,2016
371,16,7,0,23,457,5,2810,2016
38,13,7,0,20,393,5,2808,2016
39,10,2,0,12,79,15,837,2016
391,3,10,0,13,37,35,272,2016
40,30,0,0,30,83,36,868,2016
41,0,6,0,6,334,2,2220,2016
411,7,6,0,13,144,9,973,2016
42,58,24,7,89,940,9,6766,2016
421,78,96,7,181,1074,17,7758,2016
43,81,3,7,91,865,11,5857,2016
44,20,9,0,29,346,8,2564,2016
444,6,10,0,16,368,4,2329,2016
45,20,13,0,33,565,6,3929,2016
46,11,3,0,14,57,25,430,2016
461,8,0,0,8,40,20,354,2016
47,17,10,0,27,209,13,1416,2016
471,16,3,3,22,175,13,1269,2016
48,14,0,0,14,95,15,738,2016
481,7,0,0,7,93,8,842,2016
49,57,4,0,61,161,38,1772,2016
50,11,0,0,11,97,11,950,2016
500,13,9,0,22,136,16,1347,2016
501,9,3,0,12,74,16,887,2016
51,11,2,2,15,82,18,778,2016
511,7,0,0,7,852,1,6551,2016
52,17,10,0,27,460,6,3469,2016
521,65,34,0,99,956,10,7230,2016
53,61,27,10,98,779,13,5855,2016
54,34,12,0,46,319,14,2530,2016
55,41,13,5,59,590,10,4660,2016
551,16,3,0,19,195,10,1659,2016
56,6,3,0,9,90,10,929,2016
561,1,0,0,1,65,2,653,2016
57,5,6,0,11,82,13,728,2016
58,16,4,4,24,93,26,944,2016
581,20,3,0,23,458,5,2870,2016
59,7,0,3,10,282,4,1757,2016
591,7,0,0,7,124,6,830,2016
60,3,0,0,3,64,5,487,2016
61,33,2,0,35,83,42,1178,2016
62,157,75,10,242,1799,13,14919,2016
63,7,13,3,23,265,9,2038,2016
64,3,0,0,3,153,2,1044,2016
65,75,20,3,98,802,12,5792,2016
66,36,3,0,39,162,24,1363,2016
67,15,3,0,18,62,29,596,2016
68,20,0,0,20,328,6,2561,2016
681,20,0,0,20,344,6,2777,2016
682,0,0,0,0,3,0,7,2016
69,4,2,0,6,69,9,706,2016
691,0,0,0,0,28,0,223,2016
70,82,31,0,113,752,15,5035,2016
71,61,37,0,98,1049,9,8140,2016
711,38,10,0,48,306,16,2723,2016
72,13,0,0,13,173,8,1432,2016
73,24,10,0,34,327,10,2597,2016
74,79,34,3,116,853,14,5994,2016
741,3,10,0,13,75,17,574,2016
75,27,3,0,30,508,6,3394,2016
751,31,6,0,37,364,10,2656,2016
76,55,0,0,55,153,36,1441,2016
77,24,21,3,48,632,8,4365,2016
771,3,0,0,3,99,3,713,2016
78,79,37,0,116,926,13,6818,2016
79,7,0,0,7,158,4,919,2016
791,0,0,0,0,7,0,32,2016
80,61,41,6,108,1031,10,7890,2016
81,85,58,0,143,1392,10,10065,2016
82,37,7,0,44,464,9,2713,2016
83,17,14,0,31,268,12,1877,2016
84,18,0,0,18,109,17,929,2016
85,61,24,0,85,870,10,6181,2016
851,19,0,0,19,113,17,1060,2016
86,23,24,0,47,633,7,4740,2016
861,17,7,0,24,169,14,1078,2016
87,0,0,0,0,3,0,31,2016
88,0,0,0,0,14,0,58,2016
94,0,0,0,0,3,0,74,2016
95,0,0,0,0,3,0,13,2016
951,0,0,0,0,3,0,34,2016
96,0,0,0,0,3,0,23,2016
103,0,0,0,0,3,0,33,2016
104,0,0,0,0,8,0,90,2016
105,0,0,0,0,3,0,10,2016
106,0,0,0,0,3,0,21,2016
110,0,0,0,0,3,0,10,2016
112,0,0,0,0,3,0,24,2016
113,0,0,0,0,3,0,7,2016
116,0,0,0,0,7,0,55,2016
117,0,0,0,0,3,0,17,2016
119,0,0,0,0,3,0,13,2016
121,0,0,0,0,3,0,17,2016
124,0,0,0,0,3,0,13,2016
125,0,0,0,0,3,0,27,2016
126,0,0,0,0,3,0,24,2016
128,0,0,0,0,17,0,115,2016
132,0,0,0,0,3,0,21,2016
133,0,0,0,0,7,0,27,2016
134,3,0,0,3,17,18,112,2016
135,0,0,0,0,3,0,50,2016
136,0,0,0,0,3,0,24,2016
140,17,3,0,20,157,13,1071,2016
141,0,0,0,0,21,0,140,2016
142,3,0,0,3,33,9,140,2016
146,0,0,0,0,7,0,34,2016
1,2,0,0,2,2,100,34,2017
2,6,0,0,6,10,60,112,2017
201,7,0,0,7,9,78,131,2017
3,8,0,0,8,79,10,448,2017
301,0,4,0,4,23,17,110,2017
4,39,7,0,46,323,14,2381,2017
441,16,34,0,50,247,20,1671,2017
5,8,8,8,24,155,15,1020,2017
6,8,28,4,40,791,5,5308,2017
7,36,0,0,36,447,8,3764,2017
8,32,0,0,32,486,7,3941,2017
9,0,0,0,0,12,0,120,2017
10,9,0,0,9,15,60,180,2017
11,31,4,0,35,210,17,1100,2017
211,61,44,0,105,337,31,2010,2017
12,99,19,20,138,566,24,3626,2017
13,42,20,0,62,252,25,1503,2017
131,31,20,0,51,315,16,1689,2017
231,50,24,8,82,644,13,4173,2017
14,97,38,4,139,1254,11,8361,2017
214,42,17,0,59,446,13,2757,2017
15,82,36,4,122,1215,10,8693,2017
16,46,23,0,69,680,10,4184,2017
161,58,11,4,73,827,9,5664,2017
17,31,4,8,43,505,9,3335,2017
171,24,4,4,32,554,6,3429,2017
18,15,39,0,54,1204,4,7565,2017
181,23,5,0,28,225,12,1423,2017
19,4,0,0,4,146,3,1167,2017
191,12,0,0,12,60,20,396,2017
20,35,2,0,37,114,32,973,2017
21,54,8,0,62,468,13,3233,2017
22,43,25,4,72,428,17,3086,2017
23,80,14,0,94,527,18,3143,2017
24,43,15,0,58,449,13,3257,2017
25,31,7,4,42,384,11,2394,2017
26,11,16,0,27,402,7,2393,2017
27,12,15,0,27,413,7,2371,2017
28,94,28,0,122,1306,9,9632,2017
29,5,2,0,7,25,28,186,2017
30,19,4,0,23,179,13,1092,2017
31,35,17,0,52,303,17,1888,2017
32,34,12,4,50,264,19,1585,2017
33,81,16,0,97,602,16,4982,2017
34,12,11,0,23,324,7,2051,2017
35,8,12,0,20,310,6,1784,2017
36,32,12,0,44,531,8,3487,2017
361,0,8,0,8,77,10,487,2017
37,32,16,8,56,910,6,5662,2017
371,23,8,0,31,466,7,2569,2017
38,40,0,4,44,435,10,3067,2017
39,15,0,0,15,74,20,604,2017
391,17,0,0,17,36,47,254,2017
40,32,0,0,32,60,53,564,2017
41,8,8,4,20,339,6,2172,2017
411,4,16,0,20,183,11,1076,2017
42,50,51,0,101,956,11,6619,2017
421,73,51,0,124,1006,12,6857,2017
43,43,4,0,47,868,5,5946,2017
44,12,8,0,20,422,5,2879,2017
444,24,8,0,32,441,7,3090,2017
45,16,0,0,16,546,3,3964,2017
46,3,0,0,3,47,6,427,2017
461,2,0,0,2,36,6,345,2017
47,12,8,4,24,257,9,1637,2017
471,0,15,0,15,147,10,826,2017
48,8,0,3,11,99,11,973,2017
481,12,0,0,12,91,13,846,2017
49,30,20,0,50,152,33,1597,2017
50,8,0,4,12,102,12,876,2017
500,16,0,0,16,134,12,1295,2017
501,14,2,3,19,82,23,981,2017
51,17,0,0,17,89,19,679,2017
511,24,16,0,40,573,7,4523,2017
52,23,11,0,34,418,8,2620,2017
521,93,47,8,148,1067,14,7790,2017
53,70,24,0,94,771,12,5222,2017
54,24,0,0,24,257,9,1900,2017
55,64,19,0,83,607,14,4554,2017
551,32,4,0,36,197,18,1704,2017
56,7,2,0,9,72,13,668,2017
561,7,2,0,9,66,14,578,2017
57,12,2,0,14,89,16,1097,2017
58,17,5,0,22,86,26,771,2017
581,16,0,0,16,320,5,1825,2017
59,8,4,0,12,181,7,1214,2017
591,4,0,0,4,90,4,305,2017
60,0,0,0,0,47,0,211,2017
61,30,0,0,30,84,36,1041,2017
62,166,46,0,212,1509,14,12195,2017
63,24,31,0,55,319,17,2482,2017
64,27,0,0,27,135,20,837,2017
65,66,23,0,89,692,13,5019,2017
66,34,3,4,41,155,26,1277,2017
67,17,0,0,17,59,29,539,2017
68,35,0,0,35,362,10,2703,2017
681,20,4,0,24,323,7,2398,2017
682,0,0,0,0,12,0,49,2017
69,6,0,0,6,62,10,412,2017
691,0,0,0,0,27,0,205,2017
70,73,46,0,119,701,17,4589,2017
71,88,49,0,137,1250,11,8898,2017
711,11,4,4,19,292,7,2297,2017
72,0,4,0,4,105,4,841,2017
73,23,15,0,38,261,15,2130,2017
74,62,24,0,86,852,10,5775,2017
741,8,4,0,12,101,12,893,2017
75,35,8,0,43,512,8,3447,2017
751,16,12,0,28,313,9,2175,2017
76,64,2,0,66,154,43,1509,2017
77,53,8,4,65,715,9,5256,2017
771,8,4,0,12,112,11,637,2017
78,114,27,4,145,1102,13,7551,2017
79,0,0,0,0,174,0,1173,2017
791,0,0,0,0,9,0,50,2017
80,93,39,0,132,978,13,8102,2017
81,145,50,4,199,1412,14,9591,2017
82,51,4,4,59,548,11,3490,2017
83,28,0,4,32,193,17,1264,2017
84,20,0,0,20,118,17,1192,2017
85,70,31,0,101,839,12,6136,2017
851,7,4,0,11,97,11,842,2017
86,39,15,0,54,604,9,4126,2017
861,8,0,0,8,194,4,1212,2017
87,0,0,0,0,8,0,77,2017
88,0,0,0,0,4,0,38,2017
89,0,0,0,0,12,0,34,2017
951,0,0,0,0,4,0,19,2017
100,0,0,0,0,4,0,40,2017
101,0,0,0,0,4,0,12,2017
104,0,0,0,0,13,0,73,2017
105,0,0,0,0,4,0,40,2017
106,0,0,0,0,4,0,20,2017
110,0,0,0,0,4,0,16,2017
111,0,0,0,0,4,0,4,2017
117,0,0,0,0,4,0,20,2017
118,0,0,0,0,16,0,117,2017
123,4,0,0,4,8,50,62,2017
126,0,0,0,0,8,0,23,2017
127,0,0,0,0,4,0,16,2017
128,0,0,0,0,23,0,106,2017
129,0,0,0,0,4,0,15,2017
132,0,0,0,0,4,0,16,2017
133,0,0,0,0,30,0,109,2017
134,0,0,0,0,8,0,57,2017
135,0,0,0,0,8,0,83,2017
136,0,0,0,0,4,0,20,2017
140,26,9,0,35,174,20,1104,2017
141,4,0,0,4,16,25,66,2017
142,0,0,0,0,12,0,103,2017
2,4,0,0,4,7,57,123,2018
201,3,0,0,3,10,30,137,2018
3,7,0,0,7,87,8,538,2018
301,7,0,0,7,53,13,271,2018
4,44,22,5,71,344,21,2357,2018
441,28,9,0,37,218,17,1525,2018
5,54,9,4,67,237,28,1778,2018
6,24,14,0,38,860,4,5383,2018
7,34,0,0,34,406,8,3028,2018
8,41,10,0,51,376,14,3107,2018
9,21,0,0,21,71,30,670,2018
10,7,1,0,8,15,53,265,2018
11,25,7,0,32,243,13,1477,2018
211,57,14,0,71,303,23,1803,2018
12,48,53,10,111,660,17,4469,2018
13,44,22,0,66,285,23,1497,2018
131,57,12,10,79,407,19,2792,2018
231,38,7,4,49,738,7,4906,2018
14,100,36,19,155,1541,10,9455,2018
214,61,36,0,97,683,14,4634,2018
15,32,7,4,43,1117,4,7822,2018
16,32,24,3,59,664,9,4080,2018
161,59,17,6,82,1153,7,8710,2018
17,35,4,0,39,535,7,3496,2018
171,20,3,0,23,592,4,3519,2018
18,73,22,3,98,1496,7,9390,2018
181,7,3,3,13,328,4,1907,2018
19,7,0,0,7,233,3,1892,2018
191,10,0,0,10,103,10,575,2018
20,22,4,2,28,114,25,1052,2018
21,18,10,0,28,429,7,2727,2018
22,56,27,0,83,473,18,3348,2018
23,61,18,0,79,455,17,2805,2018
24,58,20,0,78,522,15,3243,2018
25,31,17,4,52,549,9,3715,2018
26,14,9,0,23,401,6,2253,2018
27,17,11,0,28,335,8,1767,2018
28,43,23,3,69,1255,5,8410,2018
29,8,1,1,10,30,33,278,2018
30,17,11,0,28,189,15,981,2018
31,32,17,0,49,303,16,1927,2018
32,29,3,0,32,253,13,1465,2018
33,63,33,0,96,584,16,4509,2018
34,30,3,4,37,339,11,2278,2018
35,10,7,4,21,316,7,2044,2018
36,10,9,0,19,566,3,3475,2018
361,7,6,0,13,161,8,852,2018
37,34,29,3,66,897,7,5515,2018
371,27,0,0,27,443,6,2372,2018
38,26,14,0,40,527,8,3566,2018
39,15,3,0,18,73,25,720,2018
391,9,0,0,9,36,25,366,2018
40,26,0,0,26,64,41,858,2018
41,34,14,0,48,328,15,2497,2018
411,10,3,0,13,216,6,1391,2018
42,88,38,0,126,925,14,6547,2018
421,87,83,0,170,1117,15,7482,2018
43,55,10,3,68,955,7,6947,2018
44,14,6,0,20,355,6,2449,2018
444,18,3,0,21,339,6,2182,2018
45,26,6,0,32,537,6,3823,2018
46,5,0,0,5,57,9,561,2018
461,7,0,0,7,42,17,408,2018
47,10,16,0,26,283,9,1759,2018
471,10,3,0,13,210,6,1187,2018
48,9,0,0,9,90,10,859,2018
481,17,5,0,22,90,24,627,2018
49,25,5,2,32,154,21,1637,2018
50,3,0,0,3,78,4,776,2018
500,6,3,0,9,93,10,909,2018
501,8,0,0,8,67,12,606,2018
51,12,3,0,15,84,18,797,2018
511,23,16,6,45,637,7,5099,2018
52,10,17,0,27,399,7,2625,2018
521,107,47,3,157,1130,14,8066,2018
53,72,66,0,138,841,16,5750,2018
54,29,6,10,45,257,18,1968,2018
55,49,35,0,84,582,14,4820,2018
551,37,7,3,47,203,23,1809,2018
56,4,0,0,4,75,5,549,2018
561,0,7,0,7,54,13,564,2018
57,7,0,0,7,85,8,728,2018
58,14,0,3,17,94,18,938,2018
581,6,0,0,6,316,2,2049,2018
59,17,0,0,17,153,11,946,2018
591,13,3,3,19,106,18,518,2018
60,0,0,0,0,33,0,184,2018
61,19,0,0,19,63,30,778,2018
62,116,63,6,185,1663,11,12455,2018
63,17,7,0,24,285,8,2256,2018
64,7,7,0,14,146,10,817,2018
65,47,40,0,87,781,11,5300,2018
66,43,8,3,54,157,34,1307,2018
67,24,0,0,24,90,27,802,2018
68,24,3,4,31,464,7,3425,2018
681,7,3,0,10,358,3,2850,2018
682,0,0,0,0,6,0,12,2018
69,5,0,0,5,75,7,519,2018
691,0,0,0,0,56,0,292,2018
70,108,34,4,146,738,20,5138,2018
71,107,50,0,157,1049,15,7270,2018
711,43,20,4,67,325,21,2191,2018
72,17,4,0,21,130,16,916,2018
73,31,42,3,76,320,24,2358,2018
74,61,32,0,93,883,11,6252,2018
741,11,7,0,18,83,22,527,2018
75,38,10,4,52,561,9,3753,2018
751,25,7,0,32,356,9,2789,2018
76,62,0,0,62,155,40,1461,2018
77,43,14,0,57,709,8,5006,2018
771,10,4,0,14,123,11,764,2018
78,108,60,3,171,1147,15,8189,2018
79,14,0,0,14,239,6,1676,2018
791,0,3,0,3,10,30,32,2018
80,94,36,8,138,990,14,7120,2018
81,135,82,4,221,1502,15,10509,2018
82,37,16,3,56,592,9,3831,2018
83,41,16,0,57,285,20,2028,2018
84,27,0,0,27,103,26,857,2018
85,52,23,3,78,761,10,5832,2018
851,27,0,0,27,157,17,942,2018
86,25,6,0,31,748,4,5463,2018
861,13,3,0,16,217,7,1574,2018
87,0,0,0,0,17,0,105,2018
88,0,0,0,0,10,0,57,2018
89,0,0,0,0,10,0,73,2018
96,0,0,0,0,3,0,6,2018
99,0,0,0,0,3,0,16,2018
101,0,0,0,0,3,0,45,2018
104,2,0,0,2,19,11,192,2018
105,0,0,0,0,4,0,18,2018
106,0,0,0,0,4,0,15,2018
110,0,0,0,0,4,0,4,2018
113,0,0,0,0,4,0,18,2018
114,0,0,0,0,3,0,6,2018
116,0,0,0,0,3,0,26,2018
117,0,0,0,0,7,0,71,2018
119,0,0,0,0,6,0,29,2018
121,0,0,0,0,10,0,64,2018
122,0,0,0,0,3,0,6,2018
123,0,0,0,0,4,0,51,2018
124,0,0,0,0,3,0,16,2018
126,0,0,4,4,4,100,26,2018
128,0,0,0,0,16,0,106,2018
133,0,0,0,0,4,0,22,2018
135,0,0,0,0,4,0,37,2018
137,0,0,0,0,4,0,11,2018
139,0,0,0,0,4,0,26,2018
140,10,3,0,13,163,8,928,2018
141,6,0,0,6,17,35,71,2018
142,6,4,0,10,20,50,72,2018
144,0,0,0,0,3,0,3,2018
1,0,0,0,0,2,0,35,2019
2,7,0,0,7,10,70,194,2019
201,6,0,0,6,10,60,127,2019
3,0,0,0,0,101,0,688,2019
301,17,3,3,23,55,42,313,2019
4,57,31,0,88,419,21,3013,2019
441,32,40,0,72,213,34,1678,2019
5,74,22,0,96,229,42,1839,2019
6,30,14,0,44,859,5,5670,2019
7,6,10,0,16,440,4,3965,2019
8,0,0,0,0,343,0,2706,2019
9,12,0,0,12,38,32,130,2019
10,10,0,0,10,15,67,180,2019
11,47,6,0,53,277,19,1354,2019
211,64,20,0,84,330,25,1815,2019
12,155,19,0,174,687,25,4820,2019
13,41,21,0,62,234,26,1222,2019
131,68,14,3,85,430,20,2716,2019
231,68,24,0,92,792,12,5244,2019
14,98,17,0,115,1582,7,10202,2019
214,84,24,3,111,637,17,4345,2019
15,75,11,0,86,1254,7,8057,2019
16,54,14,0,68,691,10,3978,2019
161,64,31,6,101,1147,9,7814,2019
17,27,0,3,30,550,5,3530,2019
171,14,13,0,27,507,5,3383,2019
18,44,33,0,77,1502,5,9884,2019
181,21,0,0,21,299,7,1541,2019
19,6,0,0,6,222,3,1461,2019
191,0,0,0,0,126,0,620,2019
20,18,5,0,23,108,21,1028,2019
21,58,13,0,71,440,16,3113,2019
22,71,19,0,90,500,18,3087,2019
23,70,43,0,113,594,19,3602,2019
24,77,0,0,77,464,17,3115,2019
25,21,3,0,24,424,6,2636,2019
26,34,0,0,34,402,8,2495,2019
27,24,17,0,41,519,8,2726,2019
28,74,23,0,97,1272,8,8623,2019
29,4,2,0,6,30,20,321,2019
30,7,0,0,7,168,4,899,2019
31,37,6,0,43,263,16,1723,2019
32,51,9,0,60,285,21,2061,2019
33,56,28,0,84,635,13,5304,2019
34,31,13,3,47,411,11,3066,2019
35,17,0,0,17,202,8,1250,2019
36,24,6,0,30,439,7,2663,2019
361,7,0,0,7,161,4,1039,2019
37,20,6,0,26,781,3,5270,2019
371,24,3,0,27,528,5,2860,2019
38,30,6,0,36,542,7,3913,2019
39,16,2,0,18,75,24,632,2019
391,7,2,0,9,29,31,367,2019
40,29,0,0,29,62,47,650,2019
41,28,13,0,41,351,12,2292,2019
411,17,16,0,33,215,15,1547,2019
42,51,30,3,84,907,9,5992,2019
421,65,68,0,133,1208,11,8221,2019
43,68,24,7,99,1011,10,7174,2019
44,22,0,0,22,180,12,1420,2019
444,11,0,0,11,164,7,1331,2019
45,11,0,0,11,118,9,1187,2019
46,5,2,0,7,53,13,435,2019
461,4,0,0,4,40,10,447,2019
47,6,0,0,6,89,7,614,2019
471,7,0,0,7,131,5,878,2019
48,13,3,0,16,97,16,967,2019
481,17,3,0,20,87,23,786,2019
49,40,18,0,58,158,37,1515,2019
50,20,0,0,20,72,28,706,2019
500,8,5,3,16,91,18,916,2019
501,22,0,0,22,73,30,687,2019
51,13,0,0,13,91,14,926,2019
511,16,10,6,32,552,6,3970,2019
52,13,6,0,19,375,5,2771,2019
521,81,41,10,132,1255,11,8932,2019
53,89,30,3,122,1045,12,6831,2019
54,21,18,10,49,266,18,2315,2019
55,18,4,0,22,303,7,2468,2019
551,19,9,0,28,173,16,1587,2019
56,10,0,0,10,89,11,905,2019
561,2,0,0,2,69,3,577,2019
57,9,2,0,11,76,14,594,2019
58,22,5,0,27,100,27,969,2019
581,14,0,0,14,324,4,2358,2019
59,6,10,0,16,228,7,1505,2019
591,3,0,0,3,90,3,386,2019
60,3,0,0,3,44,7,283,2019
61,49,5,3,57,90,63,964,2019
62,125,48,3,176,1724,10,13327,2019
63,31,24,0,55,338,16,2393,2019
64,17,0,0,17,115,15,629,2019
65,112,13,0,125,860,15,5971,2019
66,47,0,0,47,136,35,1129,2019
67,25,4,0,29,86,34,818,2019
68,17,3,0,20,427,5,3411,2019
681,30,0,0,30,413,7,3196,2019
69,7,0,0,7,74,9,565,2019
691,0,0,0,0,19,0,128,2019
70,89,54,0,143,886,16,5986,2019
71,72,27,6,105,1264,8,8919,2019
711,51,24,0,75,325,23,2503,2019
72,7,3,0,10,159,6,934,2019
73,17,10,3,30,325,9,2754,2019
74,81,21,0,102,1007,10,6699,2019
741,17,10,0,27,92,29,598,2019
75,23,10,0,33,426,8,2567,2019
751,47,10,0,57,423,13,2670,2019
76,64,2,0,66,159,42,1788,2019
77,41,6,0,47,849,6,5163,2019
771,3,3,0,6,94,6,568,2019
78,112,27,3,142,1320,11,8386,2019
79,13,0,0,13,262,5,1568,2019
791,0,0,0,0,6,0,74,2019
80,112,27,3,142,1209,12,8428,2019
81,166,85,10,261,1803,14,13212,2019
82,50,17,0,67,656,10,4127,2019
83,31,0,0,31,204,15,1481,2019
84,25,0,0,25,102,25,874,2019
85,102,9,0,111,824,13,6414,2019
851,26,0,0,26,156,17,853,2019
86,48,16,0,64,622,10,4398,2019
861,21,0,0,21,213,10,1435,2019
87,0,3,0,3,10,30,75,2019
88,3,0,0,3,10,30,71,2019
90,0,0,0,0,3,0,10,2019
91,0,0,0,0,3,0,3,2019
93,0,0,0,0,3,0,34,2019
95,0,0,0,0,3,0,27,2019
96,0,0,0,0,3,0,48,2019
98,0,0,0,0,3,0,48,2019
100,0,0,0,0,3,0,17,2019
101,3,0,0,3,3,100,17,2019
104,11,0,0,11,20,55,110,2019
105,0,0,0,0,3,0,23,2019
106,0,0,0,0,6,0,47,2019
110,0,0,0,0,10,0,41,2019
112,0,0,0,0,3,0,14,2019
116,0,0,0,0,10,0,37,2019
117,0,0,0,0,10,0,72,2019
118,0,0,0,0,17,0,193,2019
119,0,0,0,0,3,0,13,2019
121,0,0,0,0,7,0,58,2019
122,0,0,0,0,3,0,24,2019
123,3,0,0,3,3,100,17,2019
124,3,0,0,3,3,100,44,2019
126,0,0,0,0,3,0,30,2019
128,0,0,0,0,13,0,57,2019
130,0,0,0,0,3,0,13,2019
133,0,0,0,0,10,0,47,2019
137,0,0,0,0,3,0,14,2019
140,17,10,0,27,142,19,998,2019
141,0,0,0,0,6,0,29,2019
142,0,0,0,0,23,0,161,2019
143,0,0,0,0,3,0,13,2019
144,0,0,0,0,6,0,105,2019
146,0,0,0,0,3,0,3,2019
1,1,0,0,1,2,50,47,2020
2,3,1,0,4,10,40,154,2020
201,8,0,0,8,10,80,154,2020
3,11,0,0,11,134,8,920,2020
301,7,0,0,7,40,18,220,2020
4,41,28,10,79,382,21,2730,2020
441,39,14,0,53,165,32,963,2020
5,25,20,0,45,248,18,1787,2020
6,18,18,7,43,764,6,5435,2020
7,20,8,0,28,339,8,2923,2020
8,9,11,0,20,226,9,1673,2020
9,0,0,0,0,26,0,85,2020
10,12,0,0,12,15,80,179,2020
11,48,7,0,55,396,14,2182,2020
211,56,8,0,64,398,16,2198,2020
12,161,30,2,193,757,25,5350,2020
13,41,11,0,52,243,21,1620,2020
131,50,11,0,61,404,15,2889,2020
231,37,26,0,63,974,6,6912,2020
14,73,24,0,97,1642,6,10632,2020
214,65,26,3,94,710,13,4247,2020
15,68,14,0,82,1452,6,9451,2020
16,43,28,0,71,767,9,4231,2020
161,48,21,0,69,1466,5,10361,2020
17,40,11,4,55,641,9,4236,2020
171,32,10,0,42,550,8,3830,2020
18,28,17,4,49,1484,3,9777,2020
181,29,0,0,29,401,7,2489,2020
19,0,0,0,0,25,0,118,2020
191,0,0,0,0,69,0,352,2020
20,21,2,2,25,109,23,1052,2020
21,48,14,0,62,476,13,3573,2020
22,43,20,0,63,601,10,4623,2020
23,66,31,6,103,557,18,3795,2020
24,65,10,0,75,495,15,3359,2020
25,14,14,0,28,567,5,3458,2020
26,21,7,0,28,444,6,2540,2020
27,18,25,4,47,547,9,3421,2020
28,57,7,0,64,1053,6,6912,2020
29,8,0,0,8,29,28,220,2020
30,19,4,0,23,160,14,1040,2020
31,30,11,0,41,284,14,1772,2020
32,21,4,0,25,311,8,2030,2020
33,52,17,4,73,580,13,4380,2020
34,11,0,0,11,161,7,895,2020
35,7,15,0,22,280,8,2062,2020
36,58,0,0,58,495,12,3164,2020
361,7,0,0,7,128,5,773,2020
37,40,14,0,54,1026,5,7102,2020
371,21,3,0,24,619,4,3643,2020
38,18,3,0,21,620,3,4471,2020
39,8,0,0,8,75,11,795,2020
391,4,0,0,4,28,14,310,2020
40,43,0,0,43,65,66,712,2020
41,18,11,7,36,396,9,2568,2020
411,14,6,0,20,222,9,1660,2020
42,54,26,3,83,833,10,6169,2020
421,84,47,6,137,1185,12,8087,2020
43,36,21,0,57,992,6,7104,2020
44,12,0,0,12,280,4,2165,2020
444,22,0,0,22,186,12,1346,2020
45,18,0,0,18,214,8,1639,2020
46,1,6,0,7,51,14,429,2020
461,8,2,0,10,37,27,329,2020
47,4,0,0,4,94,4,793,2020
471,10,3,0,13,140,9,885,2020
48,11,2,0,13,92,14,752,2020
481,14,2,0,16,93,17,832,2020
49,35,2,7,44,155,28,1933,2020
50,0,0,0,0,73,0,586,2020
500,14,0,8,22,83,27,741,2020
501,6,0,0,6,67,9,735,2020
51,21,0,0,21,85,25,818,2020
511,14,11,7,32,559,6,4268,2020
52,25,9,0,34,476,7,2961,2020
521,100,35,7,142,1408,10,9533,2020
53,55,32,3,90,1130,8,7370,2020
54,24,5,2,31,188,16,1467,2020
55,24,17,0,41,319,13,2496,2020
551,26,8,0,34,169,20,1514,2020
56,4,0,0,4,82,5,936,2020
561,0,0,2,2,64,3,567,2020
57,8,0,0,8,73,11,650,2020
58,16,4,2,22,105,21,965,2020
581,4,7,3,14,351,4,2453,2020
59,11,0,0,11,237,5,1476,2020
591,3,0,0,3,94,3,561,2020
60,8,0,0,8,51,16,312,2020
61,36,0,0,36,86,42,1311,2020
62,95,40,11,146,1761,8,14477,2020
63,40,29,4,73,480,15,3496,2020
64,22,4,0,26,166,16,1212,2020
65,77,26,4,107,1075,10,7914,2020
66,47,6,0,53,147,36,1266,2020
67,21,3,0,24,90,27,1057,2020
68,44,3,3,50,696,7,4701,2020
681,26,7,0,33,430,8,3209,2020
682,0,0,0,0,3,0,22,2020
69,10,2,0,12,70,17,488,2020
691,0,0,0,0,25,0,81,2020
70,128,22,2,152,880,17,7414,2020
71,97,16,0,113,961,12,7511,2020
711,63,6,0,69,343,20,2881,2020
72,4,0,0,4,96,4,730,2020
73,28,3,2,33,190,17,1697,2020
74,66,4,0,70,601,12,5074,2020
741,8,0,0,8,66,12,555,2020
75,28,0,0,28,421,7,3566,2020
751,25,2,0,27,253,11,1822,2020
76,67,3,1,71,155,46,1670,2020
77,77,10,0,87,738,12,5287,2020
771,2,0,0,2,103,2,603,2020
78,136,9,0,145,888,16,6747,2020
79,15,0,0,15,358,4,2384,2020
791,0,0,0,0,14,0,100,2020
80,77,36,7,120,1502,8,11566,2020
81,114,89,11,214,2249,10,16488,2020
82,25,13,0,38,732,5,4563,2020
83,18,4,0,22,222,10,1742,2020
84,28,2,0,30,80,38,700,2020
85,105,7,0,112,988,11,7620,2020
851,26,0,0,26,185,14,1603,2020
86,39,3,0,42,814,5,5393,2020
861,0,0,0,0,234,0,1467,2020
87,4,0,0,4,21,19,125,2020
88,0,0,0,0,8,0,56,2020
89,0,4,0,4,7,57,50,2020
94,3,0,0,3,18,17,117,2020
951,0,0,0,0,3,0,35,2020
104,2,0,0,2,16,13,124,2020
106,0,0,0,0,4,0,26,2020
111,3,0,0,3,3,100,7,2020
112,0,0,0,0,8,0,79,2020
114,0,0,0,0,7,0,37,2020
115,0,0,0,0,4,0,56,2020
117,0,0,0,0,4,0,26,2020
118,0,0,0,0,7,0,31,2020
119,0,0,0,0,7,0,14,2020
121,0,0,0,0,11,0,75,2020
124,0,0,0,0,3,0,14,2020
125,4,0,0,4,4,100,11,2020
128,0,0,0,0,21,0,86,2020
129,0,0,0,0,3,0,7,2020
130,0,0,0,0,4,0,15,2020
133,0,0,0,0,18,0,129,2020
134,0,0,0,0,4,0,26,2020
137,0,0,0,0,4,0,41,2020
140,18,4,0,22,52,42,446,2020
141,8,0,0,8,14,57,55,2020
142,7,0,0,7,27,26,241,2020
145,0,0,0,0,4,0,109,2020
147,0,0,0,0,4,0,23,2020
2,5,0,0,5,10,50,115,2021
201,1,4,0,5,8,63,120,2021
3,18,0,0,18,83,22,531,2021
301,0,0,0,0,18,0,121,2021
4,78,26,4,108,412,26,3019,2021
441,16,29,0,45,209,22,1196,2021
5,43,18,0,61,252,24,1754,2021
6,9,0,0,9,780,1,5143,2021
7,36,16,2,54,450,12,3513,2021
8,33,3,0,36,403,9,3287,2021
9,10,0,0,10,32,31,202,2021
10,8,0,0,8,15,53,201,2021
11,14,4,0,18,355,5,2013,2021
211,60,18,0,78,380,21,2265,2021
12,141,25,0,166,700,24,4610,2021
13,56,28,0,84,263,32,1506,2021
131,14,18,0,32,345,9,2191,2021
231,64,37,5,106,993,11,6896,2021
14,73,44,0,117,1388,8,8835,2021
214,54,20,5,79,654,12,4390,2021
15,40,4,0,44,1345,3,8827,2021
16,40,34,5,79,790,10,5449,2021
161,47,19,5,71,1156,6,8044,2021
17,57,16,0,73,638,11,3998,2021
171,18,4,0,22,568,4,3808,2021
18,50,9,0,59,801,7,4855,2021
181,18,0,0,18,393,5,2308,2021
19,27,6,0,33,169,20,1023,2021
191,6,0,0,6,84,7,431,2021
20,23,10,0,33,110,30,1319,2021
21,103,10,4,117,550,21,3600,2021
22,88,30,4,122,563,22,3360,2021
23,70,33,0,103,540,19,3657,2021
24,89,10,6,105,516,20,3791,2021
25,28,13,0,41,574,7,3351,2021
26,14,14,0,28,605,5,3485,2021
27,27,0,0,27,565,5,3312,2021
28,47,26,0,73,1435,5,9553,2021
29,6,0,0,6,23,26,286,2021
30,14,9,0,23,184,13,1141,2021
32,22,12,0,34,302,11,2318,2021
33,35,26,0,61,552,11,4561,2021
34,35,0,0,35,468,7,3107,2021
35,13,9,0,22,247,9,1359,2021
36,22,9,0,31,671,5,4444,2021
361,0,0,0,0,161,0,1012,2021
37,22,8,0,30,866,3,5805,2021
371,13,13,5,31,592,5,3652,2021
38,21,4,0,25,468,5,2955,2021
39,17,2,0,19,70,27,584,2021
391,6,0,0,6,32,19,182,2021
40,26,0,0,26,63,41,610,2021
41,18,10,0,28,351,8,2537,2021
411,14,0,0,14,191,7,1267,2021
42,49,9,5,63,919,7,5991,2021
421,78,79,4,161,1419,11,9654,2021
43,40,35,12,87,1135,8,7880,2021
44,15,0,0,15,243,6,1683,2021
444,42,0,0,42,242,17,1851,2021
45,21,0,0,21,191,11,1571,2021
46,7,4,0,11,53,21,505,2021
461,2,2,0,4,43,9,487,2021
47,3,0,0,3,135,2,958,2021
471,12,12,0,24,198,12,1273,2021
48,10,3,0,13,93,14,869,2021
481,28,3,0,31,100,31,895,2021
49,48,7,0,55,161,34,1567,2021
50,5,0,0,5,67,7,510,2021
500,17,4,0,21,78,27,783,2021
501,16,0,0,16,67,24,540,2021
51,17,8,0,25,79,32,645,2021
511,16,21,0,37,624,6,4932,2021
52,35,8,0,43,392,11,2535,2021
521,102,45,9,156,1498,10,10712,2021
53,18,68,5,91,1297,7,8622,2021
54,17,5,3,25,192,13,1623,2021
55,45,23,0,68,305,22,2426,2021
551,28,13,0,41,168,24,1640,2021
56,5,2,0,7,79,9,688,2021
561,5,0,3,8,62,13,567,2021
58,10,2,0,12,107,11,867,2021
581,5,4,0,9,309,3,2339,2021
59,35,0,0,35,245,14,1606,2021
591,18,0,0,18,113,16,736,2021
60,4,4,0,8,59,14,523,2021
61,42,2,0,44,88,50,1182,2021
62,146,82,18,246,1741,14,14185,2021
63,28,22,0,50,473,11,3012,2021
64,5,5,0,10,120,8,762,2021
65,99,10,0,109,1145,10,8464,2021
66,49,6,0,55,134,41,1070,2021
67,19,2,2,23,89,26,793,2021
68,23,4,0,27,655,4,4484,2021
681,30,9,0,39,494,8,3697,2021
682,0,0,0,0,8,0,102,2021
69,8,0,0,8,38,21,346,2021
691,0,0,0,0,39,0,230,2021
70,119,32,6,157,887,18,7081,2021
71,120,3,0,123,814,15,6988,2021
711,34,3,0,37,250,15,1792,2021
72,3,0,0,3,60,5,389,2021
73,16,0,4,20,197,10,1722,2021
74,59,7,0,66,549,12,5026,2021
741,12,4,0,16,64,25,479,2021
75,20,0,0,20,328,6,2614,2021
751,28,0,0,28,280,10,2009,2021
76,55,0,0,55,154,36,1724,2021
77,68,11,3,82,748,11,5771,2021
771,0,0,0,0,70,0,502,2021
78,134,18,0,152,904,17,7006,2021
79,22,0,0,22,343,6,1916,2021
791,0,0,0,0,16,0,192,2021
80,107,31,9,147,1519,10,11685,2021
81,194,107,8,309,2612,12,20029,2021
82,26,18,9,53,669,8,4339,2021
83,22,0,0,22,270,8,2254,2021
84,23,0,0,23,69,33,619,2021
85,122,5,0,127,1067,12,8046,2021
851,23,0,0,23,165,14,1376,2021
86,35,14,0,49,791,6,5273,2021
87,0,0,0,0,31,0,137,2021
88,0,0,0,0,4,0,25,2021
89,0,0,0,0,22,0,151,2021
91,0,0,0,0,9,0,52,2021
951,0,5,0,5,5,100,24,2021
96,0,0,0,0,5,0,62,2021
98,0,0,0,0,4,0,29,2021
104,9,0,0,9,23,39,143,2021
109,0,0,0,0,4,0,57,2021
110,0,0,5,5,5,100,33,2021
114,0,5,0,5,10,50,62,2021
116,0,0,0,0,4,0,82,2021
117,0,0,0,0,9,0,66,2021
118,0,0,0,0,10,0,52,2021
121,0,0,0,0,5,0,24,2021
126,0,0,0,0,4,0,29,2021
128,12,0,0,12,30,40,178,2021
129,0,0,0,0,4,0,25,2021
130,0,0,0,0,5,0,62,2021
133,5,0,0,5,18,28,66,2021
134,0,5,0,5,10,50,52,2021
135,0,0,0,0,4,0,4,2021
138,0,0,0,0,5,0,19,2021
139,0,0,0,0,5,0,24,2021
140,37,5,0,42,197,21,1283,2021
141,5,0,0,5,22,23,105,2021
142,5,0,0,5,26,19,124,2021
144,0,0,0,0,5,0,14,2021
145,0,0,0,0,5,0,48,2021
1,2,0,0,2,2,100,10,2022
2,7,0,0,7,7,100,85,2022
201,2,1,0,4,10,38,137,2022
3,20,4,0,24,152,16,965,2022
301,0,0,0,0,36,0,277,2022
4,81,21,0,102,404,25,2676,2022
441,41,22,0,63,210,30,1165,2022
5,44,20,4,68,273,25,1917,2022
6,26,8,3,37,696,5,4543,2022
7,41,4,0,45,459,10,3705,2022
8,29,6,4,39,418,9,3342,2022
9,6,0,0,6,36,18,182,2022
10,9,0,0,9,15,59,112,2022
11,47,7,3,56,337,17,1869,2022
211,71,28,4,102,356,29,2019,2022
12,167,25,3,195,628,31,4054,2022
13,50,24,0,73,267,28,1448,2022
131,58,22,0,79,375,21,2440,2022
231,51,10,0,61,1002,6,6832,2022
14,110,48,4,163,1751,9,11174,2022
214,65,24,0,89,572,15,3265,2022
15,71,19,6,95,1360,7,8879,2022
16,37,17,0,54,771,7,4249,2022
161,44,21,0,65,1116,6,7601,2022
17,18,23,0,40,677,6,3835,2022
171,29,8,0,37,577,6,3725,2022
18,67,6,0,72,1157,6,7188,2022
181,24,3,0,26,404,7,2016,2022
19,11,0,0,11,181,6,1144,2022
191,7,0,2,9,67,13,339,2022
20,34,2,0,36,116,31,1055,2022
21,55,17,0,72,681,11,4532,2022
22,89,12,0,101,797,13,4951,2022
23,81,18,2,101,483,21,3439,2022
24,45,13,0,58,426,14,2780,2022
25,21,7,0,28,564,5,3385,2022
26,13,7,0,20,464,4,2715,2022
27,7,13,0,20,378,5,2403,2022
28,37,12,0,50,1224,4,8100,2022
29,4,0,0,4,27,13,270,2022
30,9,4,0,13,198,7,1090,2022
31,46,20,0,66,332,20,2305,2022
32,33,4,0,36,335,11,2213,2022
33,59,19,8,86,432,20,3511,2022
34,34,12,4,50,553,9,3761,2022
35,0,11,0,11,256,4,1547,2022
36,26,9,3,39,565,7,3467,2022
361,3,7,0,9,141,7,873,2022
37,30,8,3,41,776,5,5116,2022
371,8,12,0,20,449,5,2464,2022
38,19,11,0,30,454,7,3076,2022
39,17,3,0,20,67,29,550,2022
391,2,2,0,4,32,13,231,2022
40,34,0,0,34,64,53,632,2022
41,30,13,0,44,339,13,2056,2022
411,13,12,3,28,209,13,1348,2022
42,52,29,0,82,922,9,6146,2022
421,56,35,12,103,1347,8,9537,2022
43,78,12,0,90,1089,8,7156,2022
44,33,0,0,33,231,14,1622,2022
444,32,0,0,32,250,13,1973,2022
45,3,0,0,3,189,2,1532,2022
46,4,1,0,6,57,10,505,2022
461,5,0,0,5,38,14,451,2022
47,11,0,0,11,122,9,837,2022
471,9,5,0,15,244,6,1683,2022
48,20,5,2,27,96,28,906,2022
481,25,3,0,27,95,29,750,2022
49,35,6,2,43,157,28,1847,2022
50,5,0,0,5,65,8,619,2022
500,23,6,0,29,90,32,855,2022
501,7,3,0,10,68,15,783,2022
51,18,0,0,18,92,20,943,2022
511,12,6,3,20,568,4,4335,2022
52,42,13,4,59,472,13,3186,2022
521,102,62,10,175,1502,12,10045,2022
53,77,37,3,117,1174,10,8021,2022
54,30,4,0,34,183,19,1592,2022
55,36,24,0,60,305,20,2428,2022
551,22,5,0,27,168,16,1477,2022
56,4,2,0,6,83,7,860,2022
561,10,2,0,12,59,20,541,2022
57,11,6,0,17,67,25,516,2022
58,32,4,2,38,110,35,869,2022
581,8,3,0,10,275,4,1730,2022
59,20,0,0,20,246,8,1503,2022
591,9,0,0,9,88,11,602,2022
60,8,0,0,8,40,19,259,2022
61,27,2,0,29,90,33,1218,2022
62,136,91,13,240,1904,13,15676,2022
63,52,26,0,78,480,16,3592,2022
64,0,4,0,4,104,4,829,2022
65,72,35,0,107,1184,9,8366,2022
66,38,3,0,41,137,30,1265,2022
67,28,0,0,28,88,32,836,2022
68,38,4,4,46,845,5,6047,2022
681,28,4,0,32,570,6,3934,2022
682,0,6,0,6,11,50,51,2022
69,11,0,0,11,40,27,289,2022
691,0,0,0,0,28,0,195,2022
70,120,18,2,140,647,22,5118,2022
71,108,15,0,123,614,20,5070,2022
711,38,5,0,43,230,19,1759,2022
72,6,0,0,6,102,6,781,2022
73,25,0,0,25,173,14,1600,2022
74,75,4,2,81,486,17,4498,2022
741,10,0,0,10,73,14,525,2022
75,28,2,0,29,334,9,3006,2022
751,20,0,0,20,236,8,1523,2022
76,66,2,0,68,157,43,1716,2022
77,50,6,0,56,662,8,5164,2022
771,4,0,0,4,85,5,454,2022
78,107,12,0,119,791,15,5858,2022
79,17,7,0,24,382,6,2758,2022
791,0,3,0,3,11,25,30,2022
80,56,40,2,98,848,12,6931,2022
81,118,69,7,194,1198,16,9677,2022
82,56,23,0,79,646,12,3967,2022
83,78,3,3,83,240,35,1696,2022
84,12,0,0,12,62,20,544,2022
85,96,24,0,120,1200,10,9064,2022
851,19,3,0,22,186,12,1507,2022
86,31,11,6,48,723,7,4760,2022
861,19,0,0,19,318,6,2126,2022
87,0,0,0,0,7,0,44,2022
89,0,0,0,0,3,0,33,2022
94,0,0,0,0,3,0,14,2022
96,0,0,0,0,3,0,28,2022
102,4,0,0,4,4,100,19,2022
104,0,0,0,0,14,0,153,2022
105,0,0,0,0,4,0,12,2022
112,0,4,0,4,4,100,12,2022
114,0,0,0,0,10,0,55,2022
115,0,0,0,0,3,0,28,2022
117,0,0,0,0,6,0,17,2022
118,0,0,0,0,4,0,23,2022
121,0,3,0,3,9,29,33,2022
123,0,0,0,0,3,0,39,2022
124,0,0,0,0,7,0,18,2022
125,0,0,0,0,7,0,38,2022
126,0,0,0,0,3,0,28,2022
128,6,0,0,6,36,15,167,2022
132,0,0,0,0,3,0,14,2022
133,7,0,0,7,16,41,46,2022
134,0,0,0,0,15,0,77,2022
136,0,0,0,0,4,0,19,2022
137,0,3,0,3,3,100,3,2022
139,0,0,0,0,7,0,25,2022
140,33,12,0,45,206,22,1184,2022
141,0,0,0,0,12,0,75,2022
142,0,0,0,0,8,0,22,2022
143,0,0,0,0,3,0,8,2022
1,1,0,0,1,2,50,35,2023
2,2,0,0,2,8,20,117,2023
201,10,0,0,10,10,100,101,2023
3,13,0,0,13,160,8,911,2023
301,0,0,4,4,44,8,232,2023
4,29,14,0,43,307,14,2207,2023
441,24,14,0,38,149,26,995,2023
5,20,5,4,29,189,15,1312,2023
6,29,7,0,36,682,5,4133,2023
7,11,6,2,19,432,4,3421,2023
8,27,6,0,33,400,8,3238,2023
9,6,2,0,8,33,24,246,2023
10,9,0,0,9,13,70,194,2023
11,28,6,3,37,360,10,1945,2023
211,59,6,0,65,417,16,2396,2023
12,107,22,5,134,612,22,4194,2023
13,49,7,0,57,228,25,1251,2023
131,26,6,0,32,314,10,1905,2023
231,28,13,0,40,815,5,5413,2023
14,41,22,0,64,1375,5,8452,2023
214,37,23,0,60,525,11,3228,2023
15,39,8,5,53,1243,4,8065,2023
16,22,27,0,50,744,7,4277,2023
161,36,9,0,45,1021,4,7050,2023
17,17,6,10,33,670,5,4082,2023
171,17,6,0,23,611,4,3520,2023
18,28,27,3,58,1356,4,8432,2023
181,8,3,3,14,363,4,2072,2023
19,25,2,2,29,247,12,1772,2023
191,6,2,0,8,83,9,479,2023
20,31,0,0,31,118,27,1120,2023
21,58,35,3,96,633,15,4270,2023
22,62,31,0,92,748,12,5381,2023
23,42,13,0,55,442,12,3036,2023
24,45,14,0,59,474,12,3192,2023
25,24,3,0,27,705,4,4427,2023
26,16,6,0,22,418,5,2595,2023
27,18,0,0,18,436,4,2773,2023
28,34,6,0,40,1266,3,7863,2023
29,4,0,0,4,30,13,275,2023
30,21,6,0,27,225,12,1369,2023
31,27,0,0,27,326,8,1991,2023
32,54,22,6,81,317,26,2490,2023
33,33,10,0,42,438,10,3583,2023
34,13,0,0,13,455,3,2856,2023
35,9,3,0,12,228,5,1426,2023
36,22,3,0,24,489,5,3194,2023
361,0,0,0,0,154,0,840,2023
37,27,8,0,36,777,5,4803,2023
371,9,11,0,20,487,4,2578,2023
38,29,17,3,49,510,10,3721,2023
39,18,3,0,21,88,24,845,2023
391,12,0,0,12,30,39,280,2023
40,48,0,0,48,65,74,712,2023
41,17,25,2,43,485,9,3448,2023
411,12,10,0,22,157,14,1105,2023
42,86,21,0,107,860,12,6288,2023
421,72,38,2,112,1097,10,8050,2023
43,69,9,3,81,1058,8,7198,2023
44,35,0,0,35,295,12,2241,2023
444,24,0,0,24,289,8,2189,2023
45,20,0,0,20,249,8,1976,2023
46,6,2,0,8,55,15,597,2023
461,0,0,0,0,34,0,511,2023
47,21,0,0,21,109,19,628,2023
471,3,0,0,3,156,2,993,2023
48,7,3,0,10,90,11,838,2023
481,11,1,2,15,93,16,787,2023
49,31,5,0,36,166,22,1926,2023
50,4,0,0,4,67,6,574,2023
500,17,3,2,22,84,27,799,2023
501,10,2,0,12,56,22,450,2023
51,17,4,0,21,88,24,879,2023
511,15,0,0,15,493,3,3476,2023
52,24,13,2,40,380,10,3111,2023
521,98,56,8,161,1049,15,8325,2023
53,55,43,18,115,1170,10,8140,2023
54,18,5,2,25,177,14,1703,2023
55,23,7,2,31,312,10,2718,2023
551,18,8,0,26,176,15,1779,2023
56,4,2,0,6,91,7,962,2023
561,10,0,0,10,68,15,547,2023
57,18,0,0,18,78,23,648,2023
58,15,0,0,15,111,14,953,2023
581,14,6,0,19,410,5,2640,2023
59,10,4,0,13,278,5,2238,2023
591,14,0,0,14,135,10,1001,2023
60,0,3,0,3,52,5,281,2023
61,44,1,0,46,87,52,1129,2023
62,207,100,13,321,2270,14,19175,2023
63,35,34,0,69,533,13,3696,2023
64,8,0,0,8,143,6,909,2023
65,61,21,4,86,1101,8,7710,2023
66,42,3,0,45,141,32,1269,2023
67,14,2,0,16,92,17,878,2023
68,22,11,0,32,715,5,4996,2023
681,24,6,4,34,681,5,4719,2023
682,0,0,0,0,3,0,11,2023
69,10,0,0,10,33,30,247,2023
691,0,0,0,0,19,0,93,2023
70,118,23,2,143,648,22,5355,2023
71,86,17,0,103,669,15,5371,2023
711,38,2,0,41,211,19,1736,2023
72,6,4,0,10,64,15,576,2023
73,13,2,0,15,142,11,1314,2023
74,68,3,0,71,490,14,4373,2023
741,19,4,0,23,70,33,400,2023
75,29,0,0,29,280,10,2206,2023
751,19,0,0,19,183,10,1329,2023
76,54,3,0,57,155,37,1767,2023
77,51,5,0,56,701,8,5541,2023
771,2,0,0,2,86,3,558,2023
78,85,21,0,106,762,14,5500,2023
79,23,9,0,32,388,8,2962,2023
791,0,5,0,5,19,29,81,2023
80,53,39,2,93,847,11,7339,2023
81,97,64,8,168,1243,14,10484,2023
82,16,31,3,50,718,7,4405,2023
83,39,0,3,42,184,23,1685,2023
84,30,0,0,30,83,36,722,2023
85,90,17,0,107,1051,10,8607,2023
851,30,0,0,30,147,20,1014,2023
86,56,7,0,63,790,8,5091,2023
861,16,4,0,20,285,7,1972,2023
87,0,0,0,0,3,0,11,2023
89,0,0,0,0,4,0,18,2023
104,2,0,2,4,22,17,222,2023
105,0,0,0,0,6,0,47,2023
110,0,0,0,0,4,0,32,2023
112,4,0,0,4,4,100,7,2023
113,0,0,0,0,4,0,21,2023
114,0,0,0,0,6,0,34,2023
116,0,0,0,0,4,0,28,2023
117,0,0,0,0,10,0,51,2023
118,0,0,0,0,13,0,119,2023
127,0,0,0,0,3,0,8,2023
128,0,0,0,0,34,0,192,2023
133,0,0,0,0,18,0,78,2023
134,0,4,0,4,7,50,35,2023
135,0,0,0,0,3,0,19,2023
138,0,0,0,0,4,0,18,2023
139,0,0,0,0,3,0,22,2023
140,26,14,0,40,161,25,1279,2023
141,4,0,0,4,11,33,53,2023
142,0,0,0,0,46,0,311,2023
